////////////////////////////////////////////////////////////////////////////////
//############################################################################//
//#[#]########################################################################//
//############################################################################//
//############################################################################//
//############################################################################//
//#####################//#####################################################//
//#####################//#####################################################//
//#####################//#####################################################//
//#####################//#####################################################//
//#####################//#######################////////////////##############//
//#####################//#####################################################//
//#####################//#####################################################//
//#####################//#####################################################//
//#####################//#####################################################//
//#####################//#####################################################//
//######//#############//#####################################################//
//######//#############//#####################################################//
//######//#############//#####################################################//
//######//#############//#############################//######################//
//######//############////////////////################//######################//
//####################################################//######################//
//####################################################//######################//
//####################################################//######################//
//#########################////////////////###########//#####//###############//
//####################################################//#####//###############//
//####################################################//#####//###############//
//####################################################//#####//###############//
//####################################################//#//##//###############//
//####################################################//#####//###############//
//####################################################//#####//###############//
//####################################################//#####//###############//
//#########################A##########################//#####//###############//
//####################################################//#####//###############//
//############################################################################//
//############################################################################//
//############################################################################//
//######################################a#################################[#]#//
//############################################################################//
////////////////////////////////////////////////////////////////////////////////
