#///////////////////////////////////////////////////////////////////////////////
//############################################################################//
//#[#]########################################################################//
//############################################################################//
//############################################################################//
//############################################################################//
//############################################################################//
//#######@####################################################################//
//##############################//############################################//
//##############################//############################################//
//##############################//############################################//
//##############################//############################################//
//##############################//############################################//
//##############################//######################################@##//#//
//##############################//############################################//
//##############################//############################################//
//##############################//############################################//
//#######//##////////###########//############################################//
//#######//#####################//###############################//###########//
//#######//#####################//######################@########//###########//
//#######//#####################//###############################//###########//
//#######//#########/////////###//###############################//###########//
//#######//#####################//###############################//###########//
//#######//######################################################//###########//
//#######//######R############################################/////###########//
//#######//###################################################################//
//############################################################################//
//############################//##############################################//
//###@#####################//#//##############################################//
//##############@##########//#//#######@######################################//
//####////////#############//#/////////#######################################//
//#########################//#//##############################################//
//####//////////////#######//#//######################R#######################//
//#########################//#//##############################################//
//############################################################################//
//############################################################################//
//###############R############################################################//
//########################################################################[#]#//
//############################################################################//
////////////////////////////////////////////////////////////////////////////////
