#///////////////////////////////////////////////////////////////////////////////
//############################################################################//
//#[#]########################################################################//
//############################################################################//
//############################################################################//
//############################################################################//
//####//################################////////////////######################//
//####//#####//###############################################################//
//####//#####//###############################################################//
//####//#####//###############################################################//
//####//#####//#######////////////////########################################//
//####//#####//###############################////////////////################//
//####//#####//###############################################################//
//####//#####//###############################################################//
//####//#####//####//#########################################################//
//####//#####//####//#########################################################//
//####//#####//####//#########################################################//
//####//#####//####//######################S##################################//
//####//#####//####//#########################################################//
//####//#####//####//################################################S########//
//###########//####//#########################################################//
//###########//####//#########################################################//
//#################//#########################################################//
//##############//#//#########################################################//
//#################//#########################################################//
//#################//#########################################################//
//#################//#########################################################//
//#################//#########################################################//
//#################//#########################################################//
//############################################################################//
//############################################################################//
//############################################################################//
//############################################################################//
//############################################################################//
//############################################################################//
//############################################################################//
//############################################################################//
//########################################################################[#]#//
//############################################################################//
////////////////////////////////////////////////////////////////////////////////
