////////////////////////////////////////////////////////////////////////////////
//############################################################################//
//#[#]########################################################################//
//############################################################################//
//############################################################################//
//############################################################################//
//#####################################################//#####################//
//###############################@#####################//#####################//
//#####################################################//#####################//
//#####################################################//#####################//
//#####################################################//#####################//
//#####################################################//#####################//
//##############################////////////////##############################//
//############################################################################//
//############################################################################//
//############################################################################//
//############################################################################//
//############################################################################//
//############################################################################//
//#################################################################//##//#####//
//####///////////##################################################//##//#####//
//#############################//############//########################//#####//
//#############################//############//########################//#####//
//#############################//############//########################//#####//
//#############################//############//########################//#####//
//#############################//#@##########//##############//////####//#####//
//#############################//############//########################//#####//
//#############################//############//#####################A##//A####//
//#############################//############//#########/////////////////#####//
//#############################//############//########################//#####//
//###################@#######################//########################//#####//
//###########################################//########################//#####//
//###########################################//########################//#####//
//###########################################//#############@##########//#####//
//########################################//##################################//
//############################################################################//
//############################################################################//
//######################################a#################################[#]#//
//############################################################################//
////////////////////////////////////////////////////////////////////////////////
