////////////////////////////////////////////////////////////////////////////////
//############################################################################//
//#[#]########################################################################//
//############################################################################//
//############################################################################//
//############################################################################//
//#################################################################//#########//
//#################################################################//#########//
//#################################################################//#########//
//#################################################################//#########//
//#################################################################//#########//
//#################################################################//#########//
//#################################################################//#########//
//#######################//######////////////////##################//#########//
//#######################//##################//####################//#########//
//#######################//##################//####################//#########//
//#######################//##################//####################//#########//
//#######################//##################//####################//#########//
//#######################//#////////////////#//####################//#########//
//#######################//##################//####################//#########//
//#######################//##################////#################//##########//
//#######################//##################//###################//##########//
//#######################//##################//###################//##########//
//#######################//##################//###################//##########//
//#######################//##################//###############################//
//#######################//###################################################//
//#######################//###################################################//
//#######################//###################################################//
//############################################################################//
//################################////////////////############################//
//############################################################################//
//############################################################################//
//############################################################################//
//############################################################################//
//############################################################################//
//############################################################################//
//############################################################################//
//########################################################################[#]#//
//############################################################################//
////////////////////////////////////////////////////////////////////////////////
