////////////////////////////////////////////////////////////////////////////////
//############################################################################//
//#[#]########################################################################//
//############################################################################//
//############################################################################//
//############################################################################//
//###################/////////////##################################//########//
//##################################################################//########//
//##################################################################//########//
//##################################################################//###//###//
//##################################################################//###//###//
//##################################################################//###//###//
//#######################################################################//###//
//#######################################################################//###//
//#################################//#########################################//
//#################################//#########################################//
//#################################//#########################################//
//#################################//#########################################//
//#################################//###############################//########//
//######################//#########//#///////////////###############//########//
//######################//#########//###############################//########//
//#################################//###############################//########//
//#################################//###############################//########//
//#################################//###############################//########//
//#################################//###############################//########//
//####///##########################//###############################//########//
//#################################//###############################//########//
//########################//#######//###############################//########//
//########################//##############################////////////////####//
//########################//##################################################//
//########################//##################################################//
//########################//##################################################//
//########################//##################################################//
//########################//##################################################//
//############################################################################//
//############################################################################//
//############################################################################//
//########################################################################[#]#//
//############################################################################//
////////////////////////////////////////////////////////////////////////////////
