////////////////////////////////////////////////////////////////////////////////
//############################################################################//
//#[#]########################################################################//
//############################################################################//
//############################################################################//
//############################################################################//
//############################################################################//
//############################################################################//
//#####################################################////////////////#######//
//############################################################################//
//######################################################//####################//
//######################################################//####################//
//######################################################//####################//
//######################################################//####################//
//######################################################//####################//
//######################################################//####################//
//######################################################//####################//
//###################////////////////###################//####################//
//######################################################//####################//
//#####//###############################################//########//##########//
//#####//###############################################//########//##########//
//#####//###############################################//########//##########//
//#####//#########################################################//##########//
//#####//#########################################################//##########//
//#####//#########################################################//##########//
//#####//#########################################################//##########//
//#####//#########################################################//##########//
//#####//#########################################################//##########//
//#####//#########################################################//##########//
//#####//#####////////////////####################################//##########//
//#####//###############//########################################//##########//
//#####//###############//########################################//##########//
//#####//###############//########################################//##########//
//#####//#########################################################//##########//
//############################################################################//
//############################################################################//
//############################################################################//
//########################################################################[#]#//
//############################################################################//
////////////////////////////////////////////////////////////////////////////////
