////////////////////////////////////////////////////////////////////////////////
//############################################################################//
//#[#]########################################################################//
//############################################################################//
//############################################################################//
//#################//#########################################################//
//###############//###########################################################//
//###############//#################################//########################//
//###############//####################////////////////#######################//
//###############//###########################################################//
//###############//###########################################################//
//###############//###########################################################//
//###############//###########################################################//
//###############//###########################################################//
//###############//############################//#############################//
//###############//############################//#############################//
//###############//############################//#############################//
//###############//############################//#############################//
//########//#####//############################//#############################//
//########//###################################//#############################//
//########//###################################//#############//##############//
//#############################################//#############//##############//
//#############################################//#############################//
//#############################################//#############################//
//#################///////////////#############//#############################//
//#############################################//#############################//
//###################//########################//#############################//
//####/////////////##//########################//#############################//
//###################//########################//#############################//
//###################//#######################################################//
//###################//#################//####################################//
//###################//#################//####################################//
//###################//#################//####################################//
//###################//#################//####################################//
//############################################################################//
//############################################################################//
//############################################################################//
//########################################################################[#]#//
//############################################################################//
////////////////////////////////////////////////////////////////////////////////
