////////////////////////////////////////////////////////////////////////////////
//############################################################################//
//#[#]########################################################################//
//######################################################@#####################//
//##########################################A#################################//
//########################@###################################################//
//#########################A##############################//##################//
//########################################################//##################//
//########################################################//##################//
//########################################################//##################//
//########################################################//##################//
//####//////////##############################################################//
//########################################################////////////////####//
//############################################################################//
//############################################################################//
//#################//#########################################################//
//#################//#########################################################//
//####////#########//#################################//######################//
//#################//#################################//######################//
//#################//#################################//######################//
//#################//#################################//////##################//
//#################//#################################//##//##################//
//####################################################//##//##################//
//#####////###########################################//##//##########@#######//
//####################################################//##//##################//
//####################################################//##//##################//
//#############################@######################//##//##################//
//####################################################//##//##################//
//####################################################//##//##################//
//###########///////////////##########################//##//##################//
//####################################################//##//##################//
//############################################@#######//##//##################//
//##############//########################################//##################//
//##############//########################################//##################//
//############################################################################//
//############################################################################//
//###A########################################################################//
//######################################a#################################[#]#//
//############################################################################//
////////////////////////////////////////////////////////////////////////////////
