////////////////////////////////////////////////////////////////////////////////
//############################################################################//
//#[#]########################################################################//
//############################################################################//
//############################################################################//
//############################################################################//
//################///////////###############################//################//
//################//########################################//################//
//################//#######################/////############//################//
//################//########################################//################//
//################//########################################//################//
//################//########################################//################//
//################//########################################//################//
//#######////////#//########################################//################//
//################/////////////#############################//################//
//################//##########################################################//
//################//##########################################################//
//################//##########################################################//
//################//##########################################################//
//################//##########################//##############################//
//################//########////////////////##//##############################//
//############################################//##############################//
//############################################//##############################//
//############################################//##############################//
//############################################//##############################//
//############################################//##############################//
//############################################//##############################//
//############################################//##############################//
//############################################//##############################//
//##############//############################//##############################//
//##############//############################//##############################//
//##############//############################//##############################//
//##############//############################//##############################//
//##############//############################//##############################//
//############################################################################//
//############################################################################//
//############################################################################//
//######################################a#################################[#]#//
//############################################################################//
////////////////////////////////////////////////////////////////////////////////
