////////////////////////////////////////////////////////////////////////////////
//############################################################################//
//#[#]########################################################################//
//############################################################################//
//############################################################################//
//############################################################################//
//#####################################################////////////////#######//
//######################//////////////#################//#####################//
//#####################################################//#####################//
//###############A#####################################//#####################//
//#####################################################//#####################//
//####/////////########################################//#####################//
//#####################################################//#####################//
//#####################################################//#####################//
//#####################################################//#########//##########//
//#####################################################//#########//##########//
//#####################################################//#########//##########//
//#####################################################//A########//##########//
//#####################################################//#########//##########//
//#######################//############################//#########//##########//
//#######################//############################//#########//#@########//
//####///################//############################//#########//##########//
//#################A#####//#######################################//##########//
//#######################//#######################################//##########//
//#######################//#######################################//##########//
//#######################//#######################################//##########//
//########////////#######//######################A################//##########//
//#######################//#######################################//##########//
//#######################//#######################################//##########//
//#######################//###################################################//
//#######################//###################################################//
//#######################//###################################################//
//#######################//###################################################//
//#######################//###################################################//
//############################################################################//
//############################################################################//
//############################################################################//
//######################################a#################################[#]#//
//############################################################################//
////////////////////////////////////////////////////////////////////////////////
