////////////////////////////////////////////////////////////////////////////////
//############################################################################//
//#[#]########################################################################//
//############################################################################//
//############################################################################//
//############################################################################//
//############################################################################//
//################################################################////////####//
//############################################################################//
//############################################################################//
//############################################################################//
//#############//#############################################################//
//#############//#############################################################//
//#############//#############################################################//
//#############//#############################################################//
//####///////////############################////////////////#################//
//#############//#############################################################//
//#############//###########################################////////////////##//
//#############//#############################################################//
//###########################//###############################################//
//###########################//###############################################//
//###########################//###############################################//
//###########################//###############################################//
//###########################//########//#####################################//
//###########################//########//#####################################//
//###########################//########//#####################################//
//###################//######//########//#####################################//
//###################//######//#######///#####################################//
//###################//######//#######///#####################################//
//###################//######//#######///#####################################//
//###########################//#######///#####################################//
//###########################//#######///#####################################//
//###########################//#######///#####################################//
//###########################//#######///#####################################//
//############################################################################//
//############################################################################//
//############################################################################//
//########################################################################[#]#//
//############################################################################//
////////////////////////////////////////////////////////////////////////////////
