////////////////////////////////////////////////////////////////////////////////
//############################################################################//
//#[#]########################################################################//
//############################################################################//
//############################//#//###########################################//
//############################################################################//
//######################################################/////#################//
//######################################################//####################//
//######################################################//###########@########//
//######################################################//####################//
//######################################################//####################//
//######################################################//####################//
//######################################################//////////############//
//#################//###################################//####################//
//#################//###################################//###############//###//
//#################//###################################//###############//###//
//#################//###################################//###############//###//
//#################//##@#################################################//###//
//#################//####################################################//###//
//#################//####################################################//###//
//###############@#//####################################################//###//
//#################//####################################################//###//
//#################//####################################################//###//
//#################//####################################################//###//
//#################//####################################################//###//
//#################//##########//////####################################//###//
//#################//#############################@######################//###//
//#################//####################################################//###//
//##########//###################################@#######################//###//
//##########//#########################////////////////#######################//
//##########//############################################################A###//
//##########//##############################################///////////////###//
//############################################################################//
//############################################################################//
//############################################################################//
//###############A##########################A#################################//
//############################################################################//
//########################################################################[#]#//
//##############@#############################################################//
////////////////////////////////////////////////////////////////////////////////
