 ///////////////////////////////////////////////////////////////////////////////
//                                                                            //
// [ ]                                                                        //
//                                                                      @     //
//    F                                                             F         //
//                                                                            //
//                                              ////////////////              //
//                                                                            //
//                     @     //                                               //
//                           //                                               //
//                           //                                               //
//                           //                                               //
//                           //                                     //        //
//                           //                                     //        //
//                           //                                     //        //
//                           //                                     //        //
//                           //                                     //        //
//                           //                                     //        //
//                           //              //                               //
//                           //              //                               //
//                      //   //              //                               //
//                      //                   //                               //
//                      //                  @//                               //
//                      //      //@          //                               //
//                              //           //                               //
//                              //           //     ////////////////          //
//                              //           //                               //
//                              //         ////////////////                   //
//                              //                                            //
//                              //                                            //
//                              //                                            //
//                              //                                            //
//                     //       //                                            //
//                     //       //                       @                    //
//                                                                            //
//                                                                            //
//                                                                            //
//                                                                        [ ] //
//                                                                            //
////////////////////////////////////////////////////////////////////////////////
