////////////////////////////////////////////////////////////////////////////////
//############################################################################//
//#[#]########################################################################//
//############################################################################//
//######################################A#####################################//
//############################################################################//
//############################################################################//
//#####################################A###################################@##//
//####///#####################################################################//
//####//////##################################################################//
//############################################################################//
//################################////#############################A##########//
//############################################################################//
//####///////////////#######@##################################//#############//
//###########//################################################//###@#########//
//###########//#####################################//#########//#############//
//##################################################//#########//#############//
//##################################################////#######//#############//
//##################################################//#########//#############//
//###########################################@######//#######////#############//
//##################################################//#######////#############//
//##################################################//#######////#############//
//##################################################//#######////#############//
//################################///////////////###//#######////#############//
//##################################################//#######////#############//
//##################################################//#######////#############//
//################################@#################//#######////#############//
//##################################################//#######////##########@##//
//###########################################################//###############//
//###########################################################//###############//
//###########################################################//###############//
//###########################################################//###############//
//###########################################################//###############//
//###########################################################//###############//
//#########################################################################//#//
//############################################################################//
//############################################################################//
//######################################a#################################[#]#//
//############################################################################//
////////////////////////////////////////////////////////////////////////////////
