////////////////////////////////////////////////////////////////////////////////
//############################################################################//
//#[#]########################################################################//
//####################################################A#######################//
//############################################################################//
//############################################################################//
//###################################//#######################################//
//###################################//##A####################################//
//###################################//#######################################//
//###################################//#######################################//
//###################################//#######################################//
//###################################//#######################################//
//###################################//#######################################//
//###################################////############///////////////##########//
//###################################////#####################################//
//###################################////#####################################//
//#####################################//#####################################//
//#####################################//#####################################//
//####################@@###############//#####################################//
//#####################################//################################//###//
//#####################################//##############@############//###//###//
//#####################################//###########################//###//###//
//#####################################//###########################//###//###//
//#####################################//#///////////////###########//###//###//
//#####################################//###########################//########//
//###############@#####################//###########################//########//
//#######################@#############//###########################//########//
//#####################################//##////////////////#########//########//
//##################################################################//########//
//##################################################################//########//
//##################################################################//########//
//##################################################################//########//
//##################################################################//########//
//##################################################################//########//
//############################################################################//
//############################################################################//
//############################################################################//
//######################################a#################################[#]#//
//############################################################################//
////////////////////////////////////////////////////////////////////////////////
