////////////////////////////////////////////////////////////////////////////////
//############################################################################//
//#[#]########################################################################//
//############################################################################//
//############################################################################//
//############################################################################//
//############################################################################//
//############################################################################//
//############################################################################//
//######################################///////////////#######################//
//###########################//###############################################//
//###########################//###############################################//
//######////////////////#####//###############################################//
//###########################//############################/////##############//
//###########################//#############################//################//
//###########################//#############################//################//
//###########################//###############################################//
//###########################//###############################################//
//###########################//###############################################//
//###########################//#######################//######################//
//###########################//#######################//######################//
//###########################//#######################//######################//
//###########################//#######################//##//##################//
//###########################//#######################//##//##################//
//###########################//#######################//##//##################//
//####################################################//##//##################//
//####################################################//##//##################//
//####################################################//##//##################//
//####################################################//##//##################//
//#####//#############################################//##//##################//
//#####//#############################################//##//##################//
//####################################################//##//##################//
//########################################################//##################//
//####///////////#########################################//##################//
//#############################################################//#//##########//
//############################################################################//
//############################################################################//
//########################################################################[#]#//
//############################################################################//
////////////////////////////////////////////////////////////////////////////////
