////////////////////////////////////////////////////////////////////////////////
//############################################################################//
//#[#]########################################################################//
//############################################################################//
//############################################################################//
//############################################################################//
//######////////////////######################################################//
//#####################################################////////////////#######//
//############################################################################//
//############################################################################//
//############################################################################//
//############################################################################//
//########################################//##################################//
//########################################//#############////////////////#####//
//########################################//#################//#######////####//
//########################################//#################//#######////####//
//########################################//#################//#######////####//
//########################################//##########################////####//
//########################################//############//############////####//
//########################################//############//##############//####//
//########################################//############//##############//####//
//########################################//############//##############//####//
//######################################################//##############//####//
//######################################################//##############//####//
//######################################################//##############//####//
//######################################################//##############//####//
//######################################################//##############//####//
//######################################################//##############//####//
//######################################################//####################//
//######################################################//####################//
//############################################################################//
//############################################################################//
//############################################################################//
//############################################################################//
//############################################################################//
//############################################################################//
//############################################################################//
//########################################################################[#]#//
//############################################################################//
////////////////////////////////////////////////////////////////////////////////
