////////////////////////////////////////////////////////////////////////////////
//############################################################################//
//#[#]########################################################################//
//############################################################################//
//############################################################################//
//############################################################################//
//############################################################################//
//###################//#############////////////////##########################//
//###################//##########################//###########################//
//###################//##########################//###########################//
//###############////////////####################//###########################//
//###############################################//###########################//
//###############################################//###########################//
//###############################################//###########################//
//###############################################//###########################//
//###############################################//###########################//
//####////###############//######################//###########################//
//#######################//######################//###########################//
//#######################//######################//###########################//
//#######################//######################//###########################//
//#######################//######################//###########################//
//#######################//######################//###########################//
//#######################///////#################//###########################//
//#######################//###################################################//
//#######################//###################################################//
//#######################//##########################################//#######//
//#############//########//###########/////////////##################//#######//
//#############//########//##########################################//#######//
//#############//########//##########################################//#######//
//#######################//##########################################//#######//
//#######################//##########################################//#######//
//###################################################################//#######//
//###################################################################//#######//
//###################################################################//#######//
//############################################################################//
//############################################################################//
//############################################################################//
//######################################a#################################[#]#//
//############################################################################//
////////////////////////////////////////////////////////////////////////////////
