////////////////////////////////////////////////////////////////////////////////
//############################################################################//
//#[#]########################################################################//
//############################################################################//
//##########################################################A############A####//
//############################################################################//
//##############################//############################################//
//##############################//############################################//
//##############################//############################################//
//##############################//############################################//
//##############################//############################################//
//##############################//######////////////////################//####//
//##############################//######################################//####//
//######@#######################//#####################################@//####//
//##################@###########//########//###############//#################//
//########################################//###############//#################//
//########################################//###############//#################//
//#######////#############################//###############//#################//
//########################################//######A########//#################//
//########################################//###############//#################//
//########################################//###############//#########@#######//
//########################################//###############//#################//
//########################################//###############//#################//
//##############@#########################//###############//#################//
//########################################//###############//#################//
//########################################//###############//#################//
//####/////////////########################################//#################//
//#########################################################//#################//
//########################################//###############//#################//
//########################################//##################################//
//########################################//##################################//
//##########################//######////////////////##########################//
//##########################//######################################@#########//
//##########################//################################################//
//############################################################################//
//############################################################################//
//############################################################################//
//########################################################################[#]#//
//############################################################################//
////////////////////////////////////////////////////////////////////////////////
