////////////////////////////////////////////////////////////////////////////////
//#################################################@##########################//
//#[#]########################################################################//
//############################################################################//
//############################################################################//
//##############//############################################################//
//##############//############################################################//
//##############//############################################################//
//##############//############################################################//
//##############/////////////////#############################################//
//##############//###################A########################################//
//##############//####################################//######################//
//##############//##############//####################//######################//
//##############//##############//#########////////////////###################//
//##############//##############//############################################//
//##@#//////////////############//############################################//
//##############################//############################################//
//##############################//########################//##################//
//##############################//########################//##################//
//##############################//#################@######//##################//
//##############################//########################//##################//
//##############################//########################//##################//
//##############################//########################//##################//
//##############################//########################//##################//
//##############################//########################//##################//
//##############################//########################//##################//
//###########A##################//########################//##################//
//########################################################//##################//
//########################################################//##################//
//########################################################//##################//
//#A######################################################//##################//
//########################################################//##################//
//############################################################################//
//##################@###################################################//####//
//######################################################################//####//
//###############################@##############################@#############//
//############################################################################//
//######################################a#################################[#]#//
//############################################################################//
////////////////////////////////////////////////////////////////////////////////
