////////////////////////////////////////////////////////////////////////////////
//############################################################################//
//#[#]########################################################################//
//############################################################################//
//############################################################################//
//############################################################################//
//##########################################################//################//
//##########################################################//################//
//####################################////////////////######//################//
//##########################################################//################//
//##########################################################//################//
//#####//###################################################//################//
//#####//###################################################//################//
//#####//###################///////////////#################//################//
//#####//###################################################//################//
//#####//###################################################///////###########//
//#####//###################################################//################//
//#####//###################################################//################//
//#####////#################################################//################//
//#####////###################################################################//
//#####////###################################################################//
//#####////###################################################################//
//#####////###################################################################//
//#####////###################################################################//
//#####////###################################################################//
//#####////###################################################################//
//#######//###################################################################//
//#######//###################################################################//
//#######//###################################################################//
//#######//###################################################################//
//#######//###################################################################//
//#######//###################////////////####################################//
//#######//###################################################################//
//##################################################################//########//
//##################################################################//########//
//############################################################################//
//############################################################################//
//######################################a#################################[#]#//
//############################################################################//
////////////////////////////////////////////////////////////////////////////////
