#///////////////////////////////////////////////////////////////////////////////
//############################################################################//
//#[#]########################################################################//
//############################################################################//
//############################################################################//
//###############//###########################################################//
//############/////##////////////////############//###########################//
//##############//###################//##########//###########################//
//##############//###################//##########//###########################//
//##############//##################///##########//###########################//
//##############//##################//###########//////////////###############//
//##############//##################//###########//##////////////////#########//
//##############//##################//###########//###########################//
//##############//##################//###########//###########################//
//##############//##################//###########//###########################//
//##################################//###########//###########################//
//##################################//###########//###########################//
//##################################//###########//###########################//
//##################################//###########//###########################//
//##################################//###########//###########################//
//##################################//#S#######################S####S#########//
//##################################//########################################//
//##################################//########################################//
//##################################//########################################//
//############################################################################//
//############################################################################//
//############################################################################//
//############################################################################//
//############################################################################//
//############################################################################//
//############################################################################//
//############################################################################//
//####################/////###################################################//
//############################################################################//
//############################################################################//
//############################################################################//
//############################################################################//
//########################################################################[#]#//
//############################################################################//
////////////////////////////////////////////////////////////////////////////////
