#///////////////////////////////////////////////////////////////////////////////
//############################################################################//
//#[#]########################################################################//
//############################################################################//
//############################################################################//
//############################################################################//
//##############################//##################//########################//
//##############################//##################//########################//
//##############################//##################//###################//###//
//##############################//##################//###################//###//
//##############################//##################//###################//###//
//############////////////////##//##################//###################//###//
//##############################//##################//###################//###//
//##############################//##################//###################//###//
//##############################//##################//###################//###//
//##############################//##################//###################//###//
//##############################//##########################################S#//
//#############//###############//############################################//
//#############//###############//############################################//
//#############//###############//############################################//
//#############//#############################################################//
//#############//#############################################################//
//############################################################################//
//##UW########################################################################//
//############################################################################//
//####//////##################################################################//
//#########################################################///////////########//
//############################################################################//
//###########################################################//###############//
//#################################////////////////##########//###############//
//###########################################################//###############//
//###########################################################//###############//
//###########################################################//###############//
//###########################################################//###############//
//############################################################################//
//############################################################################//
//############################################################################//
//########################################################################[#]#//
//############################################################################//
////////////////////////////////////////////////////////////////////////////////
