#///////////////////////////////////////////////////////////////////////////////
//############################################################################//
//#[#]########################################################################//
//############################################################################//
//############################################################################//
//######@#####################################################################//
//#######################################//###################################//
//######////////////////#################//###################################//
//#######################################//###################################//
//#######################################//###################################//
//#######################################////#################################//
//####///############////////////////######//#################################//
//###############@###########@#############//######N##########################//
//############################################################################//
//############################################################################//
//############################################################################//
//###############################@############################################//
//############################################################################//
//############################################################################//
//############################################################################//
//###############//###//###############################################//#####//
//###############//###//###############################################//#####//
//###############//###//###############################################//#####//
//###############//###//###############################################//#####//
//###############//###//#####################################N#########//#####//
//###############//###//###############################################//#####//
//#########@#####//###//###############################################//#####//
//###############//###//###############################################//#####//
//###############//###//#############N#################################//#####//
//###############//###//###############################################//#####//
//###############//###//######################################################//
//###############//###//######################################################//
//####/////////////###//########@###############@#############################//
//####################//######################################################//
//####################//######################################################//
//############################################################################//
//############################################################################//
//########################################################################[#]#//
//####################N#######################################################//
////////////////////////////////////////////////////////////////////////////////
