#///////////////////////////////////////////////////////////////////////////////
//############################################################################//
//#[#]########################################################################//
//############################################################################//
//############################################################################//
//############################################################################//
//############################################################################//
//###########################################################R################//
//############################################################################//
//############################################################################//
//#########################################////////////////###################//
//######################################################//####################//
//##########################################//##########//####################//
//##########////////////////################//##########//####################//
//##########################################//##########//####################//
//#####P####################################//#########P//####################//
//##########################################//##########//####################//
//##########################################//##########//####################//
//##########################################//##########//######//############//
//######################################################//######//############//
//######################################################//######//############//
//######################################################//######//############//
//##############################################################//############//
//###########P##################################################//############//
//##############################################################//############//
//##############################################################//############//
//##############################################################//############//
//##########################////////////////####################//############//
//############################//################################//############//
//############################//################################//############//
//############################//################################//############//
//############################//################################//############//
//##//########################//################################//############//
//##//########################//#//###########################################//
//##########################//################################################//
//############################################################################//
//############################################################################//
//########################################################################[#]#//
//############################################################################//
////////////////////////////////////////////////////////////////////////////////
