#///////////////////////////////////////////////////////////////////////////////
//############################################################################//
//#[#]########################################################################//
//############################################################################//
//############################################################################//
//############################################################################//
//############################################################################//
//############################################################################//
//############################################################################//
//############################################################################//
//############################################################################//
//############################################################################//
//############################################################################//
//############################################################################//
//#############################################################S##############//
//#########################################################////////////////###//
//############################################################################//
//############################################################################//
//######//#####//#################################////////////////############//
//######//#####//##########################################//#################//
//######//#####//##########################################//#################//
//######//#####//##########################################//#################//
//######//#####//##########################################//#################//
//######//#####//##########################################//#################//
//######//#####//##########################################//#################//
//######//#####//##########################################//#################//
//######//#####//##########################################//#################//
//######//#####//##########################################//#################//
//####S#//#####//##########################################//#################//
//######//#####//##########################################//#################//
//######//#####///////////////#############################//#################//
//######//#####//##########################################//#################//
//######//#####//###########################////###########//#################//
//#########################################################//#################//
//############################################################################//
//############################################################################//
//############################################################################//
//########################################################################[#]#//
//############################################################################//
////////////////////////////////////////////////////////////////////////////////
