#///////////////////////////////////////////////////////////////////////////////
//############################################################################//
//#[#]########################################################################//
//############################################################################//
//############################################################################//
//############################################################################//
//############################################################################//
//############################################################################//
//############################################################################//
//############################################################################//
//############################################################################//
//############################################################################//
//############################################################################//
//############################################################################//
//############################################################################//
//#################################///////////////############################//
//#############################################//#############################//
//#############################################//#############//##############//
//#############################################///############//##############//
//#############################################///############/////###########//
//#############################################///############//##############//
//#############################################///############//##############//
//#############################################///############//##############//
//#############################################///############/////###########//
//#############################################///############//##############//
//#############################################///############//##############//
//####/////####################################///############//#///#####///##//
//##############################################//############//##############//
//##############################################//############//##############//
//##############################################//############//##############//
//#####################################//#######//############//##############//
//#####################################//#######//############//##############//
//####///////////////##################//#######//############################//
//#####################################//#####################################//
//############################################################################//
//############################################################################//
//############################################################################//
//########################################################################[#]#//
//############################################################################//
////////////////////////////////////////////////////////////////////////////////
