#///////////////////////////////////////////////////////////////////////////////
//############################################################################//
//#[#]########################################################################//
//#############################@##############################################//
//############################################################################//
//############################################################################//
//##################################################//#//###############//####//
//#####//###########################################//#//###############//####//
//#####//###########################################//#//###############//####//
//#####//###########################################//#//###############//####//
//#####//###########################################//#////////////#####//####//
//#####//###########################################//#//###############//####//
//##################################################//#//###############//####//
//########################////////////////##########//#//#####################//
//#############################//###################//#//#####################//
//#############################//###################//#//#####################//
//#############################//###################////######################//
//#######@#####################//###################//########################//
//#######//####################//###################//########################//
//#######//###################################################################//
//#######//#########################################////////////////##########//
//###########################################################///////##########//
//############################################################################//
//############################################################################//
//############################################################################//
//############################################################################//
//############################################################################//
//############################################################################//
//############################################################################//
//############################################################################//
//###############################@###############################@############//
//############################################################################//
//############################################################################//
//############################################################################//
//############################################################################//
//############################################################################//
//############################################################################//
//########################################################################[#]#//
//############################################################################//
////////////////////////////////////////////////////////////////////////////////
