////////////////////////////////////////////////////////////////////////////////
//############################################################################//
//#[#]########################################################################//
//############################################################################//
//############################################################################//
//#########################################################################//#//
//###############################################################//###########//
//####//////#####################################################//###########//
//###############################################################//###########//
//###############################################################//###########//
//############################################################################//
//############################################################################//
//####//##########################################################//##########//
//####//##########################################################//##########//
//####//##########################################################//##########//
//####//##########################################################//##########//
//####//##########################################################//##########//
//####//##########################################################//##########//
//####//##########################################################//##########//
//####//##########################################################//##########//
//####//##########################################################//##########//
//####//##########################################################//##########//
//####//###########################################/////////////##//##########//
//####//##//##################################################################//
//####//##//##################################################################//
//####//##//##################################################################//
//####//##//#########################################/////////////############//
//########//##################################################################//
//########//##################################################################//
//########//############################################////////////////######//
//########//###########################################//#####################//
//########//###########################################//#####################//
//########//###########################################//#####################//
//########//###########################################//#####################//
//############################################################################//
//############################################################################//
//############################################################################//
//######################################a#################################[#]#//
//############################################################################//
////////////////////////////////////////////////////////////////////////////////
