////////////////////////////////////////////////////////////////////////////////
//############################################################################//
//#[#]########################################################################//
//##########################################@#################################//
//#############################################A##############################//
//#########################################################################//#//
//###################################################//#######################//
//###################################################//#######################//
//###################################################//#######################//
//###################################################//#######################//
//###################################################//#######################//
//##############//##############@####################//#######################//
//##############//###################################//#######################//
//####////////////###################################//#######################//
//####//########//###################################//#######################//
//####//########################A####################//#######################//
//####//######################################################################//
//####//#################@####################################################//
//####//######################################################################//
//####//######################################################////#####//#####//
//####//###############################################################//#####//
//####//###############################################################//#####//
//####//#############################################################A#////###//
//####//###############################################################//#####//
//####//###############################################################//#####//
//####//###################################################//##########//#####//
//#########################################################//##########//#####//
//#########################################################//##########//####@//
//##########################@##########################################//#####//
//#####################################################################//#####//
//#############////////////////#########################/////////////////#####//
//#####################################################################//#####//
//#####################################################################//#####//
//#####################################################################//#####//
//###########################################@################################//
//############################################################################//
//############################################################################//
//######################################a#################################[#]#//
//############################################################################//
////////////////////////////////////////////////////////////////////////////////
