////////////////////////////////////////////////////////////////////////////////
//############################################################################//
//#[#]########################################################################//
//############################################################################//
//############################################################################//
//############@###############################################################//
//############################################################################//
//#########################################################//#################//
//#########################################################//#################//
//#########################################################//#################//
//#########################################################//#################//
//###################################################//####//#################//
//###################################################//####//#################//
//###################################################//####//#################//
//###################################################//####//#################//
//###################################################//####//#################//
//###################################################//####//#################//
//###################################################//####//#################//
//###################################################//#######################//
//###################################################//#######################//
//##############################################////////////////##############//
//############################################################################//
//##########################////////////////##################################//
//############################################################################//
//######################################///////////###########################//
//###########################/////////##//####################################//
//##################################//##//####################################//
//##################################//##//####################################//
//######################################//###############################//###//
//########################@#############//###############################//###//
//######################################//##############################//####//
//######################################//##############################////##//
//######################################//##############################//####//
//######################################//#########//###################//####//
//#################################################//################//#######//
//############################################################################//
//############################################################################//
//######################################a#################################[#]#//
//############################################################################//
////////////////////////////////////////////////////////////////////////////////
