////////////////////////////////////////////////////////////////////////////////
//############################################################################//
//#[#]########################################################################//
//############################################################################//
//############################################################################//
//#######################################################################//###//
//############################//#########################################//###//
//############################//##############################################//
//#####################//#####//##############################################//
//#####################//#####//##############################################//
//#####################//#####//##############################################//
//#####################//#####//##############################################//
//#####################//#####//##############################################//
//#####################//#####//##############################################//
//#####################//#####//##############################################//
//#####################//#####//##############################################//
//#####################//#####################################################//
//#####################//##############################////////////////#######//
//#####################//#######################################//############//
//####################A//#######//##############################//############//
//#######////////////////#######//##########################//##//############//
//#####################//#######//##########################//##//############//
//#####################//#######//##############################//############//
//##############################//##############################//############//
//##############################//##############################//############//
//################################################A#############//############//
//############################################################################//
//############################################################################//
//############################################################################//
//###################################////////////////#########################//
//############################################################################//
//############################################################################//
//############################################################################//
//############################################################################//
//############################################################################//
//############################################################################//
//############################################################################//
//######################################e#################################[#]#//
//############################################################################//
////////////////////////////////////////////////////////////////////////////////
