////////////////////////////////////////////////////////////////////////////////
//############################################################################//
//#[#]########################################################################//
//#####################################################################@######//
//############################################################################//
//##########################################//################################//
//####################//####################//################################//
//####################//####################//################################//
//#####################@####################//################################//
//##########################################//################################//
//##########################################//################################//
//##########################################//##########////////////////######//
//##########################################//################################//
//##########################################//##########//####################//
//##########################################//##########//####################//
//##########################################//##########//####################//
//##########################################//##########//####################//
//##########################################//##########//####################//
//###########################////////////////###########//####################//
//########################################/////////###########################//
//################################################@###########################//
//############################################################################//
//########################################################@###################//
//############################################################################//
//############################################################################//
//####////////##############//################################################//
//##########################//###########################################//###//
//##########################//###########################A###############//###//
//##########################//###############//##########@###############//###//
//##########################//###############//##########################//###//
//##########################//###############//##########################//###//
//##########################//###############//##########################//###//
//##########################//###############//##########################//###//
//##########################//###############//##########################//###//
//############################################################################//
//############################################################################//
//############################################################################//
//########################################################################[#]#//
//############################################################################//
////////////////////////////////////////////////////////////////////////////////
