#///////////////////////////////////////////////////////////////////////////////
//############################################################################//
//#[#]########################################################################//
//############################################################################//
//############################################################################//
//############################################################################//
//###################################################################//####//#//
//###################################################################//#######//
//###################################################################//#######//
//###################################################################//#######//
//############################################################################//
//############################################################################//
//##########//################################################################//
//##########//######################################//########################//
//##########//######################################//########################//
//##########//######################################//########################//
//##########//######################################//########################//
//##########//######################################//########################//
//##########//#########################////////////////#######################//
//##########//################################################################//
//##########//################################################################//
//##########//################################################################//
//##########//################################################################//
//##########//##########################################//####################//
//##########//##########################################//####################//
//##########//#############//###########################//####################//
//#########################//###########################//####################//
//#########################//#################//########//#################//#//
//#####################////////////////#######//########//####################//
//############################################//########//####################//
//############################################//########//####################//
//##############///////////////#########################//####################//
//######################################################//####################//
//######################################################//####################//
//############################################################################//
//############################################################################//
//############################################################################//
//########################################################################[#]#//
//############################################################################//
////////////////////////////////////////////////////////////////////////////////
