#///////////////////////////////////////////////////////////////////////////////
//############################################################################//
//#[#]########################################################################//
//############################################################################//
//############################################################################//
//############################################################################//
//##############################//############################################//
//##############################//############################################//
//##############################//############################################//
//##############################//########//##################################//
//########################################//##################################//
//########################################//##################################//
//########################################//##################################//
//########################################//##################################//
//########################################//############################//####//
//########################################//############################//####//
//##################////////////////######//############################//####//
//########################################//############################//####//
//########################################//############################//####//
//########################################//############################//####//
//########################################//############################//####//
//####//##################################//####////////////////########//####//
//####//##################################//############################//####//
//####//##################################//############################//####//
//####//################################################################//####//
//####//######################################################################//
//####//######################################################################//
//####//#############////////////////#########################################//
//####//######################################################################//
//####//######################################################################//
//####//######################################################################//
//####//######################################################################//
//####//######################################################################//
//####//######################################################################//
//############################################################################//
//############################################################################//
//############################################################################//
//########################################################################[#]#//
//############################################################################//
////////////////////////////////////////////////////////////////////////////////
