#///////////////////////////////////////////////////////////////////////////////
//############################################################################//
//#[#]########################################################################//
//############################################################################//
//############################################################################//
//############################################################################//
//###############################//###################//P###//################//
//#############P#################//###################//####//################//
//###############################//###################//####//################//
//###############################//#############//####//####//#P##############//
//###############################//######////////#####//####//################//
//###############################//###################//####//################//
//###############################//###################//####//################//
//###############################//###################//####//################//
//###############################//###################//######################//
//###############################//##################@########################//
//###############################//###########################################//
//###############################//###########################################//
//###############################//###########################################//
//###############################//###########################################//
//###############################//###@#######################################//
//############################################################################//
//############################################################################//
//############################################################################//
//##############################////////////////##############################//
//#######################@####################################################//
//############################################################################//
//############################################################################//
//###########################@##########//####################################//
//######################################//####################################//
//##################////////////////####///////////###########################//
//######################################//#######################P############//
//######################################//####################################//
//######################################//###########//##############@########//
//###################################################//#######################//
//############################################################################//
//############################################################################//
//################################################################@#######[#]#//
//############################################################################//
////////////////////////////////////////////////////////////////////////////////
