 ///////////////////////////////////////////////////////////////////////////////
//                                                                            //
// [ ]                                                                        //
//                                                                            //
//                                                                            //
// 1                                                      C                   //
//                                                  ///////////////           //
//                                                                            //
//                                                                            //
//                                                                            //
//                                                            //              //
//                                                            //              //
//                                                            //              //
//                                                            //              //
//                                                            //         //   //
//                                                            //         //   //
//                                                            //         //   //
//             //////////////                                 //         //   //
//    ///             //                                      //         //   //
//                    //                                      //         //   //
//                    //                                      //         //   //
//                    //                                      //         //   //
//                    //                                      //         //   //
//                    //                                      //         //   //
//                    //                                      //         //   //
//                                                                       //   //
//        C                                                              //   //
//                                                                       //   //
//                                                                       //   //
//                                                         //     G           //
//                                                         //                 //
//                                                         //                 //
//                                                         //                 //
//                 ////////////////                        //                 //
//                                                                            //
//                                                                            //
//                                                                            //
//                                                                        [ ] //
//                                                                            //
////////////////////////////////////////////////////////////////////////////////
