////////////////////////////////////////////////////////////////////////////////
//############################################################################//
//#[#]########################################################################//
//############################################################################//
//############################################################################//
//############################################################################//
//#######################################################################//###//
//#######################################################################//###//
//#######################################################################//###//
//#######################################################################//###//
//###########//##########################################################//###//
//###########//#######################################################//#//###//
//###########//#######################################################//#//###//
//####################################################################//#//###//
//####################################################################//#//###//
//####################################################################//#//###//
//###################/////////########################################//#//###//
//####################################################################//#//###//
//####################################################################//######//
//####################################################################//######//
//####///////#########################################################//######//
//##########//########################################################//######//
//##########//###############################################A########//######//
//##########//########################################################//######//
//##########//#####################A##################################//######//
//##########//########################################################//######//
//##########//################################################################//
//##########//################################################################//
//##########//################################################################//
//##########//################################################################//
//##########//########//######################################################//
//##########//########//######################################################//
//####////////########//######################################################//
//#############///////////////////////########################################//
//####################################//######################################//
//############################################################################//
//############################################################################//
//######################################a#################################[#]#//
//############################################################################//
////////////////////////////////////////////////////////////////////////////////
