 ///////////////////////////////////////////////////////////////////////////////
//                                                                            //
// [ ]                                                                        //
//                                                                            //
//                                                                            //
//                                                                            //
//                                                         //                 //
//                     ////////                            //                 //
//                                                         //                 //
//                                                         //                 //
//                           ///////////////               //                 //
//                                                         //                 //
//                                                         //         //      //
//                                            F                       //      //
//                  //       //                                       //      //
//                  //       //                                       //      //
//                  //       //                                       //      //
//                  //       //////////////////                       //      //
//                  //       //                                       //      //
//                  //       //                                       //      //
//    ////////      //       //                                               //
//                  //       //                                               //
//                  //       //                                               //
//                  //       //                                               //
//                  //       //                                               //
//                  //       //                                               //
//                  //       //                                               //
//                  //       //                                               //
//                  //       //                                               //
//                                                                            //
//                                                                            //
//                                                                            //
//                                                                            //
//                                                                            //
//                                                                            //
//                                                                            //
//                                                                       F    //
//                                                                        [ ] //
//                                                                            //
////////////////////////////////////////////////////////////////////////////////
