 ///////////////////////////////////////////////////////////////////////////////
//                                                                            //
// [ ]                                                                        //
//                                                                            //
//                                                                     B      //
//                                                                            //
//                  //                        //                              //
//                  //                        //                              //
//                  //                        //                              //
//                  //       //               //                              //
//                  //       //               //                              //
//                  //       //               //                              //
//                  //       //               //                              //
//                           //                     //                        //
//                           ///////////////        //                        //
//   B                                              //                        //
//                                                  //                        //
//                                                  //                        //
//                                                  //                        //
//                                               ////////////////             //
//                                                    //                      //
//                                                    //                      //
//                                                    //                      //
//                                                    //                      //
//                                                    //                      //
//                                                    //                      //
//                                                    //                      //
//                                                    //                      //
//               //                                   //                      //
//               //                                   //                      //
//  //////////////////    //                                                  //
//                        //                                                  //
//                        //                                                  //
//                        //                     //                           //
//                                               //                           //
//                                                                            //
//                        B                                                   //
//                                                                        [ ] //
//                        B                                                   //
////////////////////////////////////////////////////////////////////////////////
