#///////////////////////////////////////////////////////////////////////////////
//############################################################################//
//#[#]########################################################################//
//############################################################################//
//############################################################################//
//############################################################################//
//############################################################################//
//############################################################################//
//#################////////////////###########################################//
//#############//#############################################################//
//#############//#############################################################//
//#############//#############################################################//
//#############//#############################################################//
//#############//#############################################################//
//#############//////////////#################################################//
//#############//#############################################################//
//############///############################################//###############//
//############///############################################//###############//
//############///############################################//###############//
//############///############################################//###############//
//############///############################################//###############//
//############///############################################//###############//
//############///############################################//###############//
//############///########################/////###############//###############//
//############//#############################################//###############//
//############//#############################################//###############//
//############//#############################################//###############//
//############//#############################################//###############//
//############//#################////////////////############//###############//
//############//#############################################//###############//
//############//#############################################//###############//
//############################################################################//
//############################################################################//
//############################################################################//
//############################################################################//
//############################################################################//
//############################################################################//
//########################################################################[#]#//
//############################################################################//
////////////////////////////////////////////////////////////////////////////////
