////////////////////////////////////////////////////////////////////////////////
//############################################################################//
//#[#]########################################################################//
//############################################################################//
//############################################################################//
//############################################################################//
//############################################################################//
//############################################################################//
//############################################################################//
//########################################################//##################//
//########################################################//##################//
//###########////////////////#############################//##################//
//########################################################//##################//
//########################################################//##################//
//########################################################//##################//
//############//#####################//###################//##################//
//############//#####################//###################//##################//
//############//#####################//###################//##################//
//###################################//###################//##################//
//###################################//###################//##################//
//###################################//###################/////////////////###//
//###################################//###################//##################//
//###################################//###################////################//
//###################################//#####################//################//
//###################################//#####################//################//
//###################################//#####################//################//
//###################################//#####################//################//
//###################################//#####################//################//
//###################################//#####################//################//
//##########################################################//################//
//##########################################################//################//
//##########################################################//################//
//##########################################################//################//
//####################################////////////////######////##############//
//############################################################################//
//############################################################################//
//############################################################################//
//########################################################################[#]#//
//############################################################################//
////////////////////////////////////////////////////////////////////////////////
