////////////////////////////////////////////////////////////////////////////////
//############################################################################//
//#[#]########################################################################//
//############################################################################//
//############################################################################//
//############################################################################//
//######//#########################//#########################################//
//######//#########################//#####################//##################//
//######//#########################//#####################//##################//
//######//#########################//#####################//##################//
//######//#########################//#####################//###//#############//
//######//#########################//#####################//###//#############//
//######//################################################//###//#############//
//#####################################################//#//###//#############//
//#####################################################//#//###//#############//
//####///////##########################################//#//###//#############//
//#####################################################//#//###//#############//
//#####################################################//#//###//#############//
//#############################//////////##############//#//##################//
//#####################################################//#//##################//
//#####################################################//#//##################//
//############################################################################//
//############################################################################//
//############################################################################//
//############################################################################//
//############################################################################//
//############################################################################//
//############################################################################//
//############################################################################//
//########################################################////////////////####//
//############################################################################//
//############################################################################//
//############################################################################//
//#################C#####D######################////////////////##############//
//############################################################################//
//############################################################################//
//############################################################################//
//######################################b#################################[#]#//
//############################################################################//
////////////////////////////////////////////////////////////////////////////////
