#///////////////////////////////////////////////////////////////////////////////
//############################################################################//
//#[#]########################################################################//
//############################################################################//
//############################################################################//
//############################################################################//
//############################################################################//
//##############################################//############################//
//##############################################//############################//
//####////////##################################//############################//
//##############################################//############################//
//##############################################//############################//
//##############################################//############################//
//##############################################//############################//
//##############################################//############################//
//##############################################//############################//
//##############################################//############################//
//##############################################//############################//
//##############################################//############################//
//##############################################//############################//
//############################################/////////////###################//
//############################################//##############################//
//############################################//#######/////////##############//
//############################################//##############################//
//############################################/////###########################//
//######///////////////##############//#######//##############################//
//###################################//#######//##############################//
//###################################//#######//###########################//#//
//##################//###############//#######//##############################//
//##################//###############//#######//##############################//
//##################//###############//#######//##############################//
//##################//#######//######//#######//##############################//
//##################//#######//######//#######//##############################//
//##################//#######//######//#######//##############################//
//############################################################################//
//############################################################################//
//############################################################################//
//########################################################################[#]#//
//############################################################################//
////////////////////////////////////////////////////////////////////////////////
