#///////////////////////////////////////////////////////////////////////////////
//############################################################################//
//#[#]########################################################################//
//############################################################################//
//############################################################################//
//############################################################################//
//#################################################################//#########//
//#################################################################//#########//
//############///////////////######################################//#########//
//#################################################################//#########//
//#############//##################################################//#########//
//#############//##################################################//#########//
//#############//##################################################//#########//
//#############//##################################################//#########//
//#############//##################################################//#########//
//#############//##################################################//#########//
//#############//##################################################//###//####//
//#################################################################//###//####//
//#################################################################//###//####//
//#################################################################//###//####//
//#################################################################//###//####//
//#####################################////////////////#################//####//
//######################################################################//####//
//######################################################################//####//
//############################################################################//
//############################################################################//
//############################################################################//
//#########//#################################################################//
//#########//#################################################################//
//#########//########################//////////////###########################//
//#########//##################################################//#############//
//#########//##################################################//#############//
//#########//#######################################//#########//#############//
//#########//#######################################//#########//#############//
//############################################################################//
//############################################################################//
//############################################################################//
//########################################################################[#]#//
//############################################################################//
////////////////////////////////////////////////////////////////////////////////
