////////////////////////////////////////////////////////////////////////////////
//############################################################################//
//#[#]########################################################################//
//############################################################################//
//############################################################################//
//############################################################################//
//############################################################################//
//############################################################################//
//############################################################################//
//#######################################################//###################//
//#######################################################//###################//
//#####################################################////###################//
//#######################################################//###################//
//#######################################################//###################//
//#######################################################//###################//
//#######################################################//###################//
//#######################################################//###################//
//########################//#############################//###################//
//########################//####################////////////////##############//
//########################//##################################################//
//########################//###########################//#####################//
//########################//#############//############//#####################//
//########################//#############//############//#####################//
//########################//#############//############//#####################//
//########################//#############//############//#####################//
//########################//#############//############//#####################//
//########################//#############//############//#####################//
//########################//###########################//#####################//
//########################//###////////////////########////////////////#######//
//########################//###########################//#####################//
//########################//###########################//#####################//
//########################//###########################//#####################//
//####################################///##############//#####################//
//#####################################################//#####################//
//############################################################################//
//############################################################################//
//############################################################################//
//########################################################################[#]#//
//############################################################################//
////////////////////////////////////////////////////////////////////////////////
