////////////////////////////////////////////////////////////////////////////////
//############################################################################//
//#[#]########################################################################//
//############################################################################//
//############################################################################//
//############################################################################//
//############################################################################//
//#########################//#################################################//
//#############///////////#//#################################################//
//#########################//#################################################//
//#########################//#################################################//
//#########################//#################################################//
//########@################//#################################################//
//#########################//#################################################//
//#########################//#################################################//
//######//#####@###########//##############//#################################//
//######//#################//##############//#################################//
//######//#################//##############//#################################//
//######//#################//##############//#################################//
//######//#################//##############//#################################//
//######//#################################//#################################//
//######//#################################//#################################//
//######//####################################################################//
//#######################///////////////##############@#####@#################//
//########################################################////////////////####//
//#########################################################//#################//
//#####################//##################################//#################//
//#####################//##################################//#################//
//#####################//##################################//#################//
//#####################////////############################//#################//
//#####################//##################################////###############//
//#####################//##################################//#################//
//#####################//##################################//#################//
//#####################//##################################//#################//
//############################################################################//
//############################################################################//
//##############################T###O########################V################//
//######################################y#################################[#]#//
//#########################################@##################################//
////////////////////////////////////////////////////////////////////////////////
