////////////////////////////////////////////////////////////////////////////////
//############################################################################//
//#[#]########################################################################//
//############################################################################//
//############################################################################//
//############################################################################//
//############################################################################//
//############################################################################//
//############################################################################//
//####///////////////#########################################################//
//###//#######################################################################//
//############################################################################//
//############################################################################//
//############################################################################//
//############################################################################//
//##################################################################//########//
//#######################################//#########################//########//
//#######################################//#########################//########//
//#######################################//#################//######//########//
//#######################################//#################//######//########//
//#######################################//#################//######//########//
//#######################################//#################//######//########//
//###A###################################//#################//######//########//
//#######################################//#################//######//########//
//#######################################//#################//######//########//
//#######################################//#################//######//########//
//##########################//////////###//#################//######//########//
//#######################################//#################//######//#####A##//
//#######################################//#################//######//########//
//#######################################//#################//######//########//
//#######################################//#################/////////#########//
//##########################################################//################//
//##########################################################//################//
//#############################################////////////////###############//
//############################################################################//
//############################################################################//
//############################################################################//
//######################################a#################################[#]#//
//############################################################################//
////////////////////////////////////////////////////////////////////////////////
