#///////////////////////////////////////////////////////////////////////////////
//############################################################################//
//#[#]########################################################################//
//############################################################################//
//############################################################################//
//############################################################################//
//################################################//#####///////////##########//
//################################################//##########################//
//##############////////////////##################////##############//########//
//#############################//#################////##############//########//
//#############################//###################//##############//########//
//#############################//###################//##############//########//
//#############################//###################//########################//
//#############################//###################//########################//
//#############################//###################//########################//
//#############################//###################//#####################//#//
//#############################//###################//########################//
//#############################//###################//########################//
//#############################//###################//########################//
//#############################//###################//########################//
//#############################//###################//########################//
//#############################//###################//########################//
//#############################//###################//########################//
//###############################################//////////////###############//
//############################################################################//
//############################################################################//
//############################################################################//
//###########################################################//###############//
//###########################################################//###############//
//###########################################################//###############//
//###//######################################################//###############//
//####/////##################################################//###############//
//###########################################################//###############//
//###########################################################//###############//
//############################################################################//
//############################################################################//
//############################################################################//
//########################################################################[#]#//
//############################################################################//
////////////////////////////////////////////////////////////////////////////////
