#///////////////////////////////////////////////////////////////////////////////
//############################################################################//
//#[#]########################################################################//
//############################################################################//
//############################################################################//
//############################################################################//
//#############################//#############################################//
//################//###########//####################//////###################//
//################//###########//#############################################//
//################//###########//#############################################//
//################//###########//#############################################//
//################//###########////////#######################################//
//################//###########//###################################//########//
//################//###########//###################################//########//
//####//////######//###########//###################################//########//
//################//###########//###################################//########//
//################//################################################//########//
//################//################################################//########//
//################//################################################//########//
//################//#////////////////###############################//########//
//################//################################################//########//
//################//################################################//########//
//##################################################################//########//
//##################################################################//########//
//##################//##############################################//########//
//##################//##############################################//########//
//##################//##################////////////////############//########//
//##################//########################################################//
//##################//########################################################//
//############################################################################//
//############################################################################//
//############################################################################//
//############################################################################//
//############################################################################//
//############################################################################//
//############################################################################//
//############################################################################//
//########################################################################[#]#//
//############################################################################//
////////////////////////////////////////////////////////////////////////////////
