 ///////////////////////////////////////////////////////////////////////////////
//  A                                                                         //
// [ ]                                                                        //
//                                                                            //
//                                                                            //
//                                            A                               //
//                                                                            //
//                                  //                                        //
//                                  //                                        //
//                                  //                                        //
//  ////////////////                //                                        //
//                                  //                                        //
//                                  //           //                           //
//        ////////////////          //           //                           //
//                                  //           //                           //
//                                  //           //                           //
//                                  //           //                           //
//                                  //           //                           //
//                                  //           //                           //
//                                  //           // ///////////////           //
//                            ///                //   //                      //
//              //                               //   //                      //
//              //                               //                           //
//              //                               //                           //
//              //                               //      A                    //
//              //                                                            //
//              //                                                            //
//              //                                                            //
//              //                                                            //
//              //                                                            //
//              //                                                            //
//              //                                                            //
//              //                                                            //
//              //                                                            //
//              //                                                            //
//                                                                            //
//                     A                                                      //
//                                                                        [ ] //
//                                                                            //
////////////////////////////////////////////////////////////////////////////////
