////////////////////////////////////////////////////////////////////////////////
//############################################################################//
//#[#]########################################################################//
//############################################################################//
//############################################################################//
//############################################################################//
//############################################################################//
//############################################################################//
//#############################################//#############################//
//#############################################//#############################//
//#############################################//#############################//
//#############################################//#############################//
//#############################################//#############################//
//#####################################////////////////#######################//
//########################################//##################################//
//########################################//##################################//
//########################################//##################################//
//########################################//##################################//
//####//////////##########################//##################################//
//########################################//##################################//
//########################################//########################//########//
//########################################//########################//########//
//######//################################//########################//########//
//######//################################//########################//########//
//######//################################//########################//########//
//######//####################///////#####//########################//########//
//######//################################//########################//########//
//######//################################//########################//########//
//######//################################//########################//########//
//######//#######################//#################################//########//
//######//#######################//###########################################//
//######//#######################//###########################################//
//###############################//###########################################//
//###############################//######################////////////////#####//
//############################################################################//
//############################################################################//
//############################################################################//
//########################################################################[#]#//
//############################################################################//
////////////////////////////////////////////////////////////////////////////////
