////////////////////////////////////////////////////////////////////////////////
//############################################################################//
//#[#]########################################################################//
//############################################################################//
//############################################################################//
//######################################////##################################//
//#####################################//#####################################//
//#####################################//#####################################//
//#####################################//#####################################//
//#####################################//#####################################//
//#####################################//####################B################//
//#####################################//#####################################//
//#####################################//########################//###########//
//#####################################//########################//###########//
//####////#############################//########################//###########//
//#####################################//########################//###########//
//#####################################//////////####//##########//###########//
//###################################################//##########//###########//
//###################################################//##########//###########//
//###################################################//##########//###########//
//###################################################//##########//###########//
//###################################################//##########//###########//
//###################################################//##########//###########//
//###################################################//##########//###########//
//###################################################//##########//###########//
//###################################################//##########//###########//
//###################################################//##//######//////#######//
//###################################################//##//###################//
//###################################################//##//###################//
//###################################################//##//###################//
//######################################H############//##//###################//
//##########///////////////###################################################//
//############################################################################//
//#######/////////////########################################################//
//############################################################################//
//############################################################################//
//############################################################################//
//######################################a#################################[#]#//
//############################################################################//
////////////////////////////////////////////////////////////////////////////////
