////////////////////////////////////////////////////////////////////////////////
//############################################################################//
//#[#]########################################################################//
//############################################################################//
//############################################################################//
//############################################################################//
//############################//##############################################//
//############################//##############################################//
//############################//##############################################//
//############################//##############################################//
//####/////###################//#//###########################################//
//############################//#//###########################################//
//#####################//#####//#//###########################################//
//#######@#############//#####//#//###########################################//
//#####################//#####//#//###################//#####////#############//
//#####################//#####//######################//######################//
//#####################//#############################//######################//
//############################################@#######//######################//
//####################################################//######################//
//########////////////////############################//######################//
//####################################################//######################//
//####################################################//##########@###########//
//####################################################//######################//
//####################################################//############//########//
//####################################################//############//########//
//####################################################//############//########//
//####################################################//############//########//
//####@##########################A####################//############//########//
//##################################################################//########//
//##################################################################//########//
//####/////////////#################################################//########//
//##################################################################//########//
//##################################################################//########//
//##########################################################/////////////#####//
//################@###########################################################//
//##############A#############################################################//
//############################################################################//
//######################################a#################################[#]#//
//############################################################################//
////////////////////////////////////////////////////////////////////////////////
