#///////////////////////////////////////////////////////////////////////////////
//############################################################################//
//#[#]########################################################################//
//############################################################################//
//############################################################################//
//############################################################################//
//#####################################################################//#####//
//#####################################################################//#####//
//#####################################################################//#####//
//#####################################################################//#####//
//#####################################################################//##//#//
//#####################################################################//#####//
//#####################################################################//#####//
//#####################################################################//#####//
//#####################################################################//#####//
//######################################//////////////########################//
//##################////////////////##########################################//
//###########################//#########/////#################################//
//##########################///#########//####################################//
//##########################///#########//####################################//
//##########################///#########//####################################//
//##########################///#########//####################################//
//##########################//##########//####################################//
//##########################//##########//####################################//
//##########################//##########//####################################//
//##########################//##########//####################################//
//######################################//####################################//
//######################################//####################################//
//#################//###################//####################################//
//#################//###//////////////////####################################//
//#################//###################//####################################//
//#################//###################//####################################//
//#################//#########################################################//
//#################//#########################################################//
//############################################################################//
//############################################################################//
//############################################################################//
//########################################################################[#]#//
//############################################################################//
////////////////////////////////////////////////////////////////////////////////
