 ///////////////////////////////////////////////////////////////////////////////
//                                                                            //
// [ ]                                                                        //
//                                                                            //
//                                                                            //
//                                                                            //
//      //                                                                    //
//      //                                                                    //
//      //                                                                    //
//      //                                                                    //
//      //                     ////////////////                               //
//      //                                                                    //
//      //                      //////////                                    //
//      /////////                                                             //
//      //                              //                                    //
//      //                              //                                    //
//      //                              //                                    //
//      //                              //                                    //
//      //                              //                                    //
//      //                              //                                    //
//             ///////////////          //                                    //
//                                      //                                    //
//                                      //              //                    //
//                                      //              //                    //
//                                      //              //                    //
//                                      //              //                    //
//                                      //              //        A        // //
//                                      //              //               //   //
//                                      //              //               //   //
//                                                      //               //   //
//                                                                       //   //
//                                                                       //   //
//                                                                       //   //
//                                                      A                //   //
//                                                                  A         //
//                                                                            //
//                                                                            //
//                                                                        [ ] //
//           A                                                                //
////////////////////////////////////////////////////////////////////////////////
