////////////////////////////////////////////////////////////////////////////////
//############################################################################//
//#[#]########################################################################//
//############################################################################//
//############################################################################//
//############################################################################//
//############################################################################//
//############################################################################//
//############################################################################//
//############################################################################//
//############################################################################//
//#############////////////////###############################################//
//##################//#######################/////////########################//
//##################//########################################################//
//##################////////##################################################//
//##################//########################################################//
//##################//##################################################//####//
//##################//##################################################//####//
//##################//##################################################//####//
//##################//#####################################//###########//####//
//##################//#####################################//###########//####//
//#################E//#####################################//###########//####//
//##################//#####################################//###########//####//
//##################//#####################################//###########//####//
//##################//#####################################//###########//####//
//##################//#####################################////#########//####//
//##################//#####################################//###########//####//
//#########################################################//###########//####//
//#########################################################//###########//####//
//####################E####################################//###########//####//
//#####################////////////////####################//#################//
//#########################################################//#################//
//#########################################################//#################//
//#########################################################//#################//
//############################################################################//
//############################################################################//
//############################################################################//
//######################################a#################################[#]#//
//############################################################################//
////////////////////////////////////////////////////////////////////////////////
