////////////////////////////////////////////////////////////////////////////////
//############################################################################//
//#[#]########################################################################//
//############################################################################//
//####################################################@#######################//
//############################################################################//
//##########################A#############################################@###//
//#########//#######################////////////////#############//###########//
//#########//####################################################//###########//
//#########//######//############################################//###########//
//#########//######//############################################//###########//
//#########//######//########################################A###//###########//
//#########//######//############################################//###########//
//#########//######//############################################//###########//
//#########//######//############################################//###########//
//#########//######//############################################//###########//
//#########//######//#################################@##########//###########//
//#########//////////############################################//###########//
//#########//####################################################//###########//
//#########//###@################################################//###########//
//#########//####################################################//###########//
//#########//####################################################//###########//
//############################################################################//
//############################################################################//
//#####################################################//#####################//
//#####################################################//###//################//
//##########################################################//################//
//##########@########################################/////////################//
//############################################################################//
//############################################################################//
//############################################################################//
//###################################A########################################//
//########################################//////////////######################//
//############################################################################//
//#######################//###################################################//
//#######################//###################################################//
//############################################################################//
//######################################a#################################[#]#//
//##################################@#########################################//
////////////////////////////////////////////////////////////////////////////////
