#///////////////////////////////////////////////////////////////////////////////
//############################################################################//
//#[#]########################################################################//
//############################################################################//
//############################################################################//
//############################################################################//
//######//####################################################################//
//######//####################################################################//
//######//###############################################//###################//
//####//////////#########################################//###################//
//##############/////####################################//###################//
//#######################################################//###################//
//#######################################################//###################//
//#######################################################//###################//
//#######################################################//###################//
//######################//###############################//###################//
//######################//###########################S###//###################//
//######################//###############################//###################//
//######################//###############################//###################//
//######################//###############################//###################//
//######################//############////###############////////////#########//
//######################//###############################//###################//
//################//####//###############################//###################//
//##############S#//####//#######################////////////////#############//
//################//####//####################################################//
//################//####//####################################################//
//####//////#S####//####//####################################################//
//################//####//####################################################//
//################//####################################################S#####//
//################//##########################################################//
//################//##########################################################//
//################//##########################################################//
//################//##########################################################//
//################///#########################################################//
//#################//#########################################################//
//############################################################################//
//############################################################################//
//########################################################################[#]#//
//############################################################################//
////////////////////////////////////////////////////////////////////////////////
