#///////////////////////////////////////////////////////////////////////////////
//############################################################################//
//#[#]########################################################################//
//############################################################################//
//############################################################################//
//############################################################################//
//########################//##################################################//
//########################//##################################################//
//########################//##################################################//
//####/////###############//##################################################//
//#######//###################################################################//
//#######//###################################################################//
//#######//###################################################################//
//#######//############################//////////////################//#######//
//#######//##########################################################/////####//
//#######//##########################################################//#######//
//#######//############//############################################//#######//
//#######//############//######################################S#####//#######//
//#######//############//############################################//#######//
//#######//############//############################################//#######//
//####////////////#####//############################################//#######//
//##############S######//############################################//#######//
//#####################//############################################//#######//
//#####################//############################################//#######//
//#####################//############################################//#######//
//#####################//############################//////////////////#######//
//#####################//#####################################################//
//#####################//#####################################################//
//#####################//#####################################################//
//#####################//#####################################################//
//#####################//#####################################################//
//############################################################################//
//###########################///#####################//#######################//
//###################################################//#######################//
//############################################################################//
//############################################################################//
//############################################################################//
//########################################################################[#]#//
//############################################################################//
////////////////////////////////////////////////////////////////////////////////
