#///////////////////////////////////////////////////////////////////////////////
//############################################################################//
//#[#]########################################################################//
//############################################################################//
//############################################################################//
//############################################################################//
//##############################################################//############//
//##############################################################//############//
//##############################################################//############//
//##########////////////////####################################//############//
//####///////###############S###################################/////#########//
//##############################################################//############//
//##############################################################//############//
//############################################################################//
//############################################################################//
//############################################################################//
//######################################//####################################//
//##########################//##########//####################################//
//##########################//##########//####################################//
//##########################//##########//####################################//
//##########################//##########//####################################//
//##########################//##########//####################################//
//##########################//##########//###//////###########################//
//##########################//##########//##//####//////////////##############//
//######################################//##//################################//
//######################################//##//################################//
//######################################//##//#########//#####################//
//######################################//##//#########//#####################//
//######################################//##//#########//#####################//
//######################################//##//#########//#####################//
//######################################//##//################################//
//##########################################//################################//
//##########################################//################################//
//####/////#################################//################################//
//#######################R#############R######################################//
//############################################################################//
//############################################################################//
//########################################################################[#]#//
//############################################################################//
////////////////////////////////////////////////////////////////////////////////
