////////////////////////////////////////////////////////////////////////////////
//############################################################################//
//#[#]########################################################################//
//############################################################################//
//##############@#########################################################@###//
//############################################################################//
//###########################//############@#####//############//#############//
//###########################//##################//############//#############//
//###########################//##################//############//#############//
//###############################################//############//#############//
//####################################//#########//############//#############//
//####################################//#######################//#############//
//############################################################################//
//############################################################################//
//############################################################################//
//############################################################################//
//############################################################################//
//#############@############//################################################//
//##########################//################################################//
//##########################//###########################///////////////######//
//######////////////////####//###########//###################################//
//##########################//###########//###################################//
//##########################//###########//###################################//
//##########################//###########//###################################//
//##########################//###########//###################################//
//##########################//#############################//#################//
//##########################//#############################//#################//
//##########################//#############################//#################//
//##########################//#############################//#################//
//##########################//#############################//#################//
//###############///////////////###########################//#################//
//############@############################################//#################//
//#########################################################//#################//
//#########################################################//#################//
//############################################################################//
//############################################################################//
//############################################################################//
//##############################################################@#########[#]#//
//############################################################################//
////////////////////////////////////////////////////////////////////////////////
