////////////////////////////////////////////////////////////////////////////////
//############################################################################//
//#[#]########################################################################//
//############################################################################//
//############################################################################//
//############################################################################//
//###################################//#######################################//
//###################################//#######################################//
//###################################//#######################################//
//###################################//#######################################//
//###################################//#######################################//
//###################################//#######################################//
//###################################//#######################################//
//###################################//#######################################//
//############################################################################//
//###############////////////////#############################################//
//#########################################################//#################//
//#########################################################//#################//
//#########################################################//#################//
//#########################################################//#################//
//#########//##############################################//#################//
//#########//##############################################//#################//
//#########//##############################################//#################//
//#########/////////////////#############A####################################//
//#########//#################################################################//
//#########//######################################A##########//##############//
//#########//####################################//###########//##############//
//###########################//##################//###########//##############//
//###########################//##//////////////////###########################//
//###########################//#//###############//###########################//
//###########################//#//###############//###########################//
//###########################//#//###############//###########################//
//###########################//#//###############//###########################//
//###########################//#//###############//###########################//
//############################################################################//
//############################################################################//
//############################################################################//
//######################################a#################################[#]#//
//############################################################################//
////////////////////////////////////////////////////////////////////////////////
