////////////////////////////////////////////////////////////////////////////////
//############################################################################//
//#[#]########################################################################//
//############################################################################//
//############################################################################//
//############################################################################//
//#######//###################################################################//
//#######//##########////////////////#########################################//
//#######//###################################################################//
//###########################################//###############################//
//####///####################################//###############################//
//###########################################//###############################//
//###########################################//###############################//
//###########################################//###############################//
//###########################################//###############################//
//###########################################//###############################//
//###########################################//###############################//
//###########################################//###############################//
//########////////////////###################//###############################//
//###//#//###################################//###############################//
//################//#########################//###############################//
//################//####################//###//###############################//
//################//####################//###//###############################//
//################//####################//####################################//
//################//####################//####################################//
//################//####################//####################################//
//################//####################//####################################//
//################//####################//####################################//
//################//####################//////////////########################//
//################//####################//####################################//
//################//####################//####################################//
//################//####################//####################################//
//######################################//####################################//
//############################################################################//
//#########################################################################//#//
//############################################################################//
//############################################################################//
//########################################################################[#]#//
//############################################################################//
////////////////////////////////////////////////////////////////////////////////
