#///////////////////////////////////////////////////////////////////////////////
//############################################################################//
//#[#]########################################################################//
//############################################################################//
//############################################################################//
//############################################################################//
//############################################//###########//#################//
//############################################//###########//#################//
//############################################//###########//#################//
//############////////////////################//###########//#################//
//############################################//###########//#################//
//############################################//###########//#################//
//############################################//###########//#################//
//#########################################################//#################//
//############################################################################//
//##########################//##################################//############//
//##########################//##################################//############//
//##########################//##################################//############//
//##########################//##################################//############//
//##########################//###################//#############//############//
//##########################//###################//#############//############//
//##########################//###################//#############//############//
//###############################################//#############//############//
//###############################################//#############//############//
//###############################################//#############//############//
//###############################################//#############//############//
//###############################################//#############//############//
//###########################################////////////////###//############//
//##############################################################//############//
//##############################################################//############//
//############################################################################//
//############################################################################//
//############################################################################//
//########################////////////////####################################//
//############################################################################//
//############################################################################//
//############################################################################//
//########################################################################[#]#//
//############################################################################//
////////////////////////////////////////////////////////////////////////////////
