#///////////////////////////////////////////////////////////////////////////////
//############################################################################//
//#[#]########################################################################//
//############################################################################//
//############################################################################//
//############################################################################//
//#######################################//##########//##//###################//
//#######################################//##########//##//###################//
//#######################################//######@#######//###################//
//#######################################//##############//#####@######//#####//
//#######################################//############################//#####//
//####//////////////#####################//############################//#####//
//####################################//###############################//#####//
//#######################//###########//###############################//##@##//
//########################//##########//###############################//#####//
//########################//##########//###############################//#####//
//########################//##########//###############################//#####//
//########################//##########//###############################//#####//
//########################//##########//###############################//#####//
//####################################//######################@########//#####//
//####################################//###############################//#####//
//###################################////////////////##################//#####//
//#####################################################################//#####//
//#####################################################################//#####//
//############################################################################//
//############################################################################//
//############################################################################//
//############################################################################//
//############################################################################//
//############################################################################//
//############################################################################//
//#######################//###################################################//
//#######################//############################@####////////////////##//
//#######################//###################################################//
//########################################################################@###//
//############################################################################//
//############################################################################//
//########################################################################[#]#//
//############################################################################//
////////////////////////////////////////////////////////////////////////////////
