#///////////////////////////////////////////////////////////////////////////////
//############################################################################//
//#[#]########################################################################//
//############################################################################//
//############################################################################//
//############################################################################//
//############################################################################//
//##################///////////////#####################///////////###########//
//#################################################################//#########//
//#################################################################//#########//
//####////#########################################################//#########//
//#################################################################//#########//
//#################################################################////#######//
//#################################################################//#########//
//#####################################//##########################//#########//
//#####################################//##########################//#########//
//#####################################//##########################//#########//
//#####################################///#########################//#########//
//#####################################///#########################//#########//
//#####################################///#########################//#########//
//#####################################///#########################//#########//
//#####################################///#########################//#########//
//#####################################///####################################//
//#####################################///####################################//
//#####################################///####################################//
//#####################################///####################################//
//#####################################///####################################//
//#####################################///####################################//
//#####################################///####################################//
//######################################//####################################//
//######################################//####################################//
//######################################//####################################//
//####################################################///////////////#########//
//############################################################################//
//############################################################################//
//############################################################################//
//############################################################################//
//########################################################################[#]#//
//############################################################################//
////////////////////////////////////////////////////////////////////////////////
