#///////////////////////////////////////////////////////////////////////////////
//############################################################################//
//#[#]########################################################################//
//############################################################################//
//############################################################################//
//############################################################################//
//############################################################################//
//##############################################//############################//
//##############################################//############################//
//##############################################//############################//
//##############################################//############################//
//##############################################//############################//
//##############################################//############################//
//####//########################################//############################//
//####//########################################//############################//
//####//########################//////////////////############################//
//####//########################################//////########################//
//####//########################################//############################//
//####//########################################//############################//
//####//########################################//############################//
//####//########################################//############################//
//####//######################################################################//
//####//#////////////////#####################################################//
//####//####################################################//################//
//####//####################################################//################//
//####//####################################################//################//
//####//####################################################//################//
//####//##############################////////////##########//################//
//##########################################################//################//
//#########//###############################################//################//
//#########//###############################################//################//
//#########//###############################################//################//
//#########//###############################################//################//
//#########//#################################################################//
//############################################################################//
//#########################################################################//#//
//############################################################################//
//########################################################################[#]#//
//############################################################################//
////////////////////////////////////////////////////////////////////////////////
