#///////////////////////////////////////////////////////////////////////////////
//############################################################################//
//#[#]########################################################################//
//############################################################################//
//############################################################################//
//############################################################################//
//############################################################################//
//############################################################################//
//#################################//#########################################//
//#################################//#########################################//
//#################################//#########################################//
//#################################//#########################################//
//#################################//#########################################//
//#################################//#########################################//
//#################################//#########################################//
//#################################//#########################################//
//#################################///////####################################//
//#################################//#########################################//
//#################################//#########################################//
//#################################///////######//############################//
//#################################//###########//#######################//###//
//#################################//###########//#######################//###//
//#################################//###########//#######################//###//
//##############################################//#######################//###//
//####################////////////////##########//#######################//###//
//#######////////////////#######################//#######################//###//
//##############################################//#######################//###//
//##############################################//#######################//###//
//##################///////#####################//#######################//###//
//##############################################//#######################//###//
//##############################################//#######################//###//
//##############################################//#######################//###//
//##############################################//#######################//###//
//##############################################//#######################//###//
//############################################################################//
//############################################################################//
//############################################################################//
//########################################################################[#]#//
//############################################################################//
////////////////////////////////////////////////////////////////////////////////
