////////////////////////////////////////////////////////////////////////////////
//############################################################################//
//#[#]########################################################################//
//############################################################################//
//############################################################################//
//############################################################################//
//#############################//#//#######################//#####//##########//
//#############################//#//#######################//#####//##########//
//#############################//#//#######################//#####//##########//
//################################//#######################//#####//##########//
//################################//#######################//#####//##########//
//################################//#######################//#####//##########//
//#########################################################//#####//##########//
//######////////////////###################################//#####//##########//
//################################################################//##########//
//#########################################//#####################//##########//
//#########################################//#####################//##########//
//#########################################//#####################//##########//
//#########################################//#################################//
//#########################################//#################################//
//###################//####################//###########////////##############//
//###################//####################//#################################//
//####//////////#####//####################//#################################//
//#########################################//#################################//
//#########################################//#################################//
//#########################################//#################################//
//############################################################################//
//############################################################################//
//############################################################################//
//##################################################################////######//
//####/////////////###########################################################//
//############################################################################//
//############################################################################//
//############################################################################//
//############################################################################//
//############################################################################//
//############################################################################//
//########################################################################[#]#//
//############################################################################//
////////////////////////////////////////////////////////////////////////////////
