#///////////////////////////////////////////////////////////////////////////////
//############################################################################//
//#[#]########################################################################//
//############################################################################//
//############################################################################//
//############################################################################//
//############################################################################//
//############################################################################//
//############################################################################//
//############################################################################//
//#################################################////////////////###########//
//##########################################################//#//#############//
//##########################################################//#//#############//
//##########################################################//#//#############//
//##########################################################//#//#############//
//##########################################################//#//#############//
//##########################################################//#//#############//
//##########################//#################################//#############//
//#########################///######//#########################//#############//
//#########################///######//#########################//#############//
//##########################//######//########################################//
//##########################//######//########################################//
//##########################//######//########################################//
//##########################//######//########################################//
//##########################//######//########################################//
//##########################//######//########################################//
//##########################//######//########################################//
//##########################//######//########################################//
//##########################//######//########################################//
//##############////////////////####//########################################//
//##################################//########################################//
//##################################//########################################//
//##################################//########################################//
//#########################/////////#//////###################################//
//############################################################################//
//############################################################################//
//############################################################################//
//########################################################################[#]#//
//############################################################################//
////////////////////////////////////////////////////////////////////////////////
