#///////////////////////////////////////////////////////////////////////////////
//############################################################################//
//#[#]########################################################################//
//############################################################################//
//################################################################@###########//
//############################################################################//
//##############//#######################################################//###//
//##############//#######################################################//###//
//#############///###########################//###############################//
//#############//############################//###############################//
//#############//############################//###############################//
//#############//############################//###############################//
//#############//############################//###############################//
//#############//###################//#######//###############################//
//#############//###################//#######//###############################//
//#############//###################//#######//###############################//
//#############//###################//#######//###############################//
//#############//###################//#######//@##############################//
//#############//###################//########################################//
//#############//////////////////###//########################################//
//#############//###################//################////////////////########//
//#############//###################//#################################@######//
//#############################@####//########################################//
//##################################//########################################//
//######////////////################//###############################@########//
//##################################//########################################//
//##################################//##############################@#######@#//
//##################################//########################################//
//############################################################################//
//####/////###################################################################//
//############################################################################//
//#######################################@####################################//
//############################################################################//
//############################################################################//
//############################################################################//
//############################################################################//
//############################################################################//
//#########################@##############################################[#]#//
//############################################################################//
////////////////////////////////////////////////////////////////////////////////
