////////////////////////////////////////////////////////////////////////////////
//############################################################################//
//#[#]########################################################################//
//############################################################################//
//############################################################################//
//############################################################################//
//############################################################################//
//###############//###########################################################//
//###############//###########################################################//
//###############//###########################################################//
//###############//###########################################################//
//###############//######//###################################################//
//###############//######//######################A############################//
//###############//######//################////////////////###################//
//###############//######//###################################################//
//###############//######//###################################################//
//###############//######//###################################################//
//###############//######//#####################################//############//
//###############//######//#####################################//############//
//###############//######//#####################################//############//
//###############//######//#####################################//############//
//###############//######//##############////////////////#######//############//
//#####////////////////##//#####################################//############//
//#######################//#####################################//############//
//#######################//#####################################//############//
//#######################//#####################################//############//
//##############################################################//############//
//##############################################################//############//
//##############################################################//############//
//##############################################################//############//
//##############################################################//############//
//##############################################################//############//
//############################################################################//
//############################################################################//
//#############################################A##############################//
//############################################################################//
//############################################################################//
//######################################a#################################[#]#//
//############################################################################//
////////////////////////////////////////////////////////////////////////////////
