#///////////////////////////////////////////////////////////////////////////////
//############################################################################//
//#[#]########################################################################//
//############################################################################//
//############################################################################//
//############################################################################//
//######################################################//##############//####//
//######################################################//##############//####//
//######################################################//##############//####//
//######################################################//##############//####//
//######################################################//##############//####//
//######################################################//##############//####//
//######################################################//##############//####//
//######################################################################//####//
//######################################################################//####//
//###########//#########################################################//####//
//###########//#########################################################//####//
//###########//#////////////////########################################//####//
//####/////##//#########################################################////##//
//###########//#########################################################//####//
//###########//#########################################################//####//
//###########//###############################################################//
//###########/################################################################//
//###########//################////////////////###############################//
//###########//############################////////////#######################//
//###########//###############################################################//
//###########//########################################################//#####//
//###########//########################################################//#####//
//###########//########################################################//#####//
//###########//########################################################//#####//
//#####################################################################//#####//
//#####################################################################//#####//
//############################################################################//
//############################################################################//
//############################################################################//
//############################################################################//
//############################################################################//
//########################################################################[#]#//
//############################################################################//
////////////////////////////////////////////////////////////////////////////////
