////////////////////////////////////////////////////////////////////////////////
//############################################################################//
//#[#]########################################################################//
//############################################################################//
//#######################@####################################################//
//############################################################################//
//##########################//################################################//
//##########################//################################################//
//##########################//################################################//
//##########################//################################################//
//############//############//###########################################//###//
//############//############//####//////#################################//###//
//############//#########################################################//###//
//############//#########################################################//###//
//####///////////########################################################//###//
//#######################################################################//###//
//#######################################################################//###//
//#######################################################################//###//
//###############//######################################################//###//
//###############//###########################################################//
//######//#######//###########################################################//
//###@##//#######//###########################################################//
//######//#######//###########################################################//
//######//#######//###########################################################//
//######//#######//###########################################################//
//######//#######//############################////////////////###############//
//######//#######//###########################################################//
//######//#######//###########################################################//
//######//#######//###########################################################//
//######//#######//###########################################################//
//######//#######//###########################################################//
//###############//#@#########################################################//
//###############//###########################################################//
//################////////////////############################################//
//############################################################################//
//############################################################################//
//############################################################################//
//########################################################################[#]#//
//############################################################################//
////////////////////////////////////////////////////////////////////////////////
