 ///////////////////////////////////////////////////////////////////////////////
//                                                                            //
// [ ]                                                                        //
//                                                                            //
//                                                                            //
//                                                                            //
//        D                                                                   //
//                           //////////////                                   //
//                                                                            //
//                      //                                                    //
//    //////////        //                                                    //
//        //            //                                    ///////      // //
//        //            //                                                    //
//        //            //                                                    //
//        //            //                                                    //
//        //            //     ///////////////                                //
//        //            //                                                    //
//        //            //                                                    //
//        //            //                                                    //
//        //            //                                                    //
//        //            //                                                    //
//        //            //              //                                    //
//        //            //              //                                    //
//        //                            //                                    //
//        //                            //                                    //
//        //                            //                                    //
//                                      //                                    //
//                                      //                                    //
//                                  //  //                                    //
//                                  //                                        //
//                                  //                                        //
//                                  //                                     // //
//  //                              //                                        //
//    ///                           //                                        //
//                              D                                             //
//                                                                            //
//                          D                                                 //
//                                                                        [ ] //
//                                                                            //
////////////////////////////////////////////////////////////////////////////////
