#///////////////////////////////////////////////////////////////////////////////
//############################################################################//
//#[#]########################################################################//
//############################################################################//
//############################################################################//
//############################################################################//
//######################################################################//####//
//######################################################################//####//
//#############################//#######################################////##//
//#############################//#######################################//####//
//#############################//#######################################//####//
//#############################//#######################################//####//
//#############################//#######################################//####//
//#############################//####################//////////////#####//####//
//#############################//#################################///###//####//
//#############################//#######################################//####//
//####//////////////###########//#######################################//####//
//#############################//#######################################//####//
//#############################//#######################################//####//
//####################//#######/////####################################//####//
//####################//#######//#############################################//
//####################//#######//#############################################//
//####################//#######//#############################################//
//####################//######################################################//
//####################//######################################################//
//####################//######################################################//
//####################//######################################################//
//####################//##////////////########################################//
//####################//######################################################//
//####################//######################################################//
//####################//######################################################//
//####################//######################################################//
//############################################################################//
//############################################################################//
//############################################################################//
//############################################################################//
//############################################################################//
//########################################################################[#]#//
//############################################################################//
////////////////////////////////////////////////////////////////////////////////
