#///////////////////////////////////////////////////////////////////////////////
//############################################################################//
//#[#]############################################################@###########//
//############################################################################//
//############################################################################//
//###################################################@########################//
//############################################################################//
//#######N####################################################//##############//
//############################################################//##############//
//####@##################################////////////////#####//##############//
//############################################################//##############//
//######################################################@####N//##############//
//#########@######//##########################################//##############//
//################//##################################/////////////###########//
//################//##########################################################//
//################//##########################################################//
//################//########//################################################//
//################//##########///#############################################//
//################//##########################################################//
//################//##########################################################//
//################//######################################//################@#//
//####/////////////#######################################//##################//
//#############//#########################################//##################//
//#############//#########################################//##################//
//#############//#########################################//##################//
//#############//#########################################//##################//
//#############//#########################################//##################//
//#############//#########################################//####N#############//
//#############//#########################################//#######N##########//
//#############//#########################################//##################//
//#############//#########################################//##################//
//########################################################//##################//
//########################################################//##################//
//########################################################//##################//
//############################################################################//
//############################################################################//
//###########################################################################@//
//########################################################################[#]#//
//############################################################################//
////////////////////////////////////////////////////////////////////////////////
