////////////////////////////////////////////////////////////////////////////////
//############################################################################//
//#[#]########################################################################//
//############################################################################//
//############################################################################//
//############################################################################//
//############################################################//######//######//
//############################################################//######//######//
//##############################//############################//##############//
//##############################//############################//##############//
//##############################//############################//##############//
//############################################################//##############//
//############################################################//##############//
//############################################################################//
//############################################################################//
//#########################//////////////#####################################//
//#################################//////////////#############################//
//############################################################################//
//##########################################################//################//
//##########################################################//###########//###//
//##########################################################//###########//###//
//##########################################################//###########//###//
//#############################//###########################//###########//###//
//#############################//###########################//###########//###//
//#############################//###########################//################//
//#############################//##////////////////#########//################//
//#############################//###########################//################//
//#############################//###########################//################//
//#############################//###########################//################//
//#############################//###########################//################//
//#############################//###########################//################//
//#############################//###########################//################//
//#############################//###########################//################//
//#############################//#############################################//
//############################################################################//
//############################################################################//
//############################################################################//
//########################################################################[#]#//
//############################################################################//
////////////////////////////////////////////////////////////////////////////////
