#///////////////////////////////////////////////////////////////////////////////
//############################################################################//
//#[#]########################################################################//
//############################################################################//
//############################################################################//
//############################################################################//
//############################################################################//
//############################################################################//
//################//##########################################################//
//################//#####################//#############//####################//
//################//#####################//#############//####################//
//################//####################################//####################//
//################//####################################//####################//
//################//####################################//####################//
//################//##########////////////////##########//####################//
//################//####################################//####################//
//################//####################################//####################//
//################//####################################//####################//
//################//####################################//####################//
//################//####################################//####################//
//################//####################################//####################//
//########//######//####################################//####################//
//########//######//####################################///////////###########//
//########//############################################///////###############//
//########//##################################################################//
//########//##################################################################//
//########//#################################################################///
/########//####////##########################################################///
/########//################////////////////#################################S///
/########//##################################################################///
/########//##################################################################///
/########//##################################################################///
/########//##################################################################///
/########//##################################################################///
/############################################################################///
/############################################################################///
/############################################################################///
/########################################################################[#]#///
/############################################################################///
////////////////////////////////////////////////////////////////////////////////
