#///////////////////////////////////////////////////////////////////////////////
//############################################################################//
//#[#]########################################################################//
//############################################################################//
//#############################//#############################################//
//###############################//################//#########################//
//##########################//####################//##########################//
//##########################//################################################//
//##########################//################################################//
//##########################////////##########################################//
//####////##################//################################################//
//##########################//################################################//
//##########################//################################################//
//##########################//################################################//
//##########################//################################################//
//###########//###############################################################//
//###########//###############################################################//
//####/////##//###############################################################//
//###########//###################//##########################################//
//###########//###################//###################################//#####//
//###########//###################//###################################//#####//
//####////////////################//##########################################//
//################/////###########//##########################################//
//################################//####################/#####################//
//################################//####################//####################//
//################################//####################//#####////###########//
//################################//####################//####################//
//################################//####################////##################//
//####////////////################//####################//####################//
//################################//###########S#S######//####################//
//################################//####################//####S###############//
//######################################################//####################//
//######################################################//####################//
//######################################################//####################//
//############################################################################//
//############################################################################//
//############################################################################//
//########################################################################[#]#//
//############################################################################//
////////////////////////////////////////////////////////////////////////////////
