////////////////////////////////////////////////////////////////////////////////
//############################################################################//
//#[#]########################################################################//
//############################################################################//
//############################################################################//
//##############################//############################################//
//##############################///############################//#############//
//##############################///############################//#############//
//##############################///############################//#############//
//##############################///############################//#############//
//##############################///############################//#############//
//##############################///############################//#############//
//##############################///############################//#############//
//###########////////////////###///##########@################///#############//
//##############################///###########################///#############//
//##############################///###########################//##############//
//###############################//#####################//////////////########//
//###############################//##############################//###########//
//###############################//##############################//###########//
//##################////////////////#############################//###########//
//###########################################################@###//###########//
//###############################################################//###########//
//###############################################################//###########//
//########//##################################################################//
//########//###############@##################################################//
//############################################################################//
//############################################################################//
//############################################################################//
//############################################################################//
//############################################################################//
//#########################################@##################################//
//############################################################################//
//############################################################################//
//############################################################################//
//############################################################################//
//##############################@#############################################//
//#####################################################################@######//
//########################################################################[#]#//
//############################################################################//
////////////////////////////////////////////////////////////////////////////////
