#///////////////////////////////////////////////////////////////////////////////
//############################################################################//
//#[#]########################################################################//
//############################################################################//
//############################################################################//
//############################################################################//
//############################################################################//
//############################################################################//
//####///////////////#########################################################//
//#########################/////##############################################//
//############################//##############################################//
//############################//###########################################//#//
//############################################################################//
//############################################################################//
//############################################################################//
//#######//###################################################################//
//#######//############################################################//#####//
//#######//############################################################//#####//
//#######//############################################################//#####//
//#######//############################################################//#####//
//#######//############################################################//#####//
//#######//############################################################//#####//
//#######//####################///////////////#########################//#####//
//#######//####################//######################################//#####//
//#######//####################//######################################//#####//
//#######//####################//######################################//#####//
//#######//####################//#///////////////######################//#####//
//#######//####################//######################################//#####//
//#######//####################//######################################//#####//
//#######//####################//######################################//#####//
//#############################//######################################//#####//
//#############################//#########################################//##//
//#############################//#############################################//
//#############################//#############################################//
//############################################################################//
//############################################################################//
//##################################################################\#########//
//########################################################################[#]#//
//############################################################################//
////////////////////////////////////////////////////////////////////////////////
