 ///////////////////////////////////////////////////////////////////////////////
//                                                                            //
// [ ]                                                                        //
//                                                                            //
//                                                                            //
//                                                                            //
//                                                 @     //                   //
//                        //////////                     //                   //
//                                                       //          //       //
//                                                       //          //       //
//                                                       //          //       //
//        ////////////////                               ///////     //       //
//                                                       ////        //       //
//                                                       ////        //       //
//                                                       ////        //  @    //
//    ///                                                ////        //       //
//                                                       ////        //       //
//                                                         //        //       //
//                                                         //        //       //
//                                                         ///       //       //
//                                                          //       //       //
//                                                                   //       //
//                                       @                           //       //
//                                                                            //
//                                                                            //
//                                                                            //
//                                                                            //
//                                                                            //
//                                                                            //
//                                                            //              //
//                                     //////////             //              //
//                                                            //              //
//                     @                    //                // //           //
//                                          //                // /////////    //
//                                                                            //
//                                                                            //
//                                                                            //
//                                                                        [ ] //
//                                                       1                    //
////////////////////////////////////////////////////////////////////////////////
