#///////////////////////////////////////////////////////////////////////////////
//############################################################################//
//#[#]########################################################################//
//############################################################################//
//############################################################################//
//############################################################################//
//#####################////###########################//######//##############//
//########################//##########################//######//##############//
//########################//##########################//######################//
//########################//##################################################//
//########################//##################################################//
//########################//##################################################//
//########################//##################################################//
//###########////#########//##################################################//
//########################//##################################//##############//
//########################//##################################//##############//
//########################//##################################//##############//
//########################//##################################//##############//
//########################//##################################//##############//
//########################//##################################//##############//
//########################//#########S#######S################//##S###########//
//##//////////////########//##################################//##############//
//############################################################//##############//
//############################################################//##############//
//##########################//################################//##############//
//####/////////////#########//################################//##############//
//##########################//################################################//
//##########################//################################################//
//##########################//################################################//
//##########################//################################################//
//##########################//################################################//
//##########################//################################################//
//##########################//#######################################/########//
//##########################//#####################////////////////##//#######//
//############################################################################//
//############################################################################//
//############################################################################//
//########################################################################[#]#//
//############################################################################//
////////////////////////////////////////////////////////////////////////////////
