 ///////////////////////////////////////////////////////////////////////////////
//                                                                            //
// [ ]                                                                        //
//                                                                            //
//                                                                            //
//                                                                            //
//          //                             ////////////////                   //
//          //                                                                //
//          //               A                                                //
//          //                                                              A //
//          //                                                                //
//          //                                                                //
//          //        //                                                      //
//          //        //                                   //                 //
//          //        //                                  A//                 //
//          //        //                                   //                 //
//          //        //                                   //                 //
//          //        //                                   //                 //
//          //        //                                   //                 //
//          //        //                                   //                 //
//                    //                                   //                 //
//                    //                                   //                 //
//                    //                                   //                 //
//                    //                                   //                 //
//                    //                                   //                 //
//                    //                                   //                 //
//                    //                 ////////////////  //                 //
//                                                         //                 //
//                                                                            //
//                                                                            //
//                                                               A            //
//                                                   ////////////////         //
//                                                                            //
//                                                                            //
//                                                                            //
//                                                                            //
//                                                                            //
//                                                                        [ ] //
//                                                                            //
////////////////////////////////////////////////////////////////////////////////
