#///////////////////////////////////////////////////////////////////////////////
//############################################################################//
//#[#]########################################################################//
//############################################################################//
//############################################################################//
//############################################################################//
//#################################//#########################//##############//
//#################################//#########################//##############//
//#################################//#########################//##############//
//#################################//#########################//##############//
//#################################//#########################//##############//
//#################################//#########################//##############//
//############################################################//##############//
//############################################################//##############//
//###################//##################//###################//##############//
//###################//##################//###################################//
//###################//##################//###################################//
//###################//##################//###################################//
//###################//############//####//###################################//
//###################//############//####//###################################//
//#################################//####//###################################//
//#################################//####//###################################//
//#################################//###//####################################//
//#################################//###//####################################//
//######################//#########//##////////////////#######################//
//######################//#########//#########################################//
//######################//#########//#####////////////////####################//
//######################//####################################################//
//#####################////////////////#######################################//
//############################################################################//
//############################################################################//
//############################################################################//
//############################################################################//
//############################################################################//
//############################################################################//
//############################################################################//
//############################################################################//
//########################################################################[#]#//
//############################################################################//
////////////////////////////////////////////////////////////////////////////////
