#///////////////////////////////////////////////////////////////////////////////
//############################################################################//
//#[#]########################################################################//
//############################################################################//
//############################################################################//
//############################################################################//
//############################################################################//
//############################################################################//
//################//##########################################################//
//################//#####################//#############//####################//
//################//#####################//#############//####################//
//################//####################################//####################//
//################//####################################//####################//
//################//####################################//####################//
//################//##########////////////////##########//####################//
//################//####################################//####################//
//################//####################################//####################//
//################//####################################//####################//
//################//####################################//####################//
//################//####################################//####################//
//################//####################################//####################//
//########//######//####################################//####################//
//########//######//####################################///////////###########//
//########//############################################///////###############//
//########//##################################################################//
//####S###//##################################################################//
//########//######################################S###########################//
//########//####////##########################################################//
//########//################////////////////##################################//
//########//##################################################################//
//########//##################################################################//
//########//##################################################################//
//########//##################################################################//
//########//##################################################################//
//############################################################################//
//############################################################################//
//############################################################################//
//########################################################################[#]#//
//############################################################################//
////////////////////////////////////////////////////////////////////////////////
