#///////////////////////////////////////////////////////////////////////////////
//############################################################################//
//#[#]########################################################################//
//############################################################################//
//############################################################################//
//############################################################################//
//############################################################################//
//#######################################################//###################//
//#######################################################//################@##//
//#######################################################//###################//
//#######################################################//###########@#######//
//#######################################################//###########//######//
//#######################################################//####@######//######//
//#######################################################//###########//######//
//#######################################################//##//#######//######//
//###########################################################//#######//######//
//###########################################################//#######//######//
//###############################@###############///#########//#######//######//
//###################////////////////########################//#######//######//
//#################//////////////############################//#######//######//
//####################//#####################################//#######//######//
//####################//#####################################//#######//######//
//####################//#####################################//#######//######//
//####################//#####################################//#######//######//
//####################//#####################################//#######//######//
//####################//#####################################//#######//######//
//####################//#####################################//###############//
//###########################################################//###############//
//###########################################################//###############//
//####//////////////##########################################################//
//#################@##########################################################//
//############################################################################//
//############################################################################//
//############################################################################//
//############################################################################//
//############################################################################//
//############################################################################//
//########################################################################[#]#//
//############################################################################//
////////////////////////////////////////////////////////////////////////////////
