////////////////////////////////////////////////////////////////////////////////
//############################################################################//
//#[#]########################################################################//
//############################################################################//
//############################################################################//
//############################################################################//
//#################################////////////////#####//####################//
//######################################################//####################//
//######################################################//####################//
//######################################################//####################//
//############################################################################//
//############################################################################//
//############################################################################//
//###########################////////////////#################################//
//##############////////////////##############################################//
//##############################################################//############//
//##############################################################//############//
//##############################################################//############//
//##############################################################//############//
//#####//#######################################################//############//
//####///#######################################################//############//
//####///#######################################################//############//
//####///#######################################################//############//
//####///#######################################################//############//
//####///#######################################################//############//
//####///#######################################################//############//
//####///###############G#######################################//############//
//####///#######################################################//############//
//####///#######################################################//############//
//####///#######################################################//############//
//####///#####################################################################//
//#####//#######################################C#############################//
//#####//#####################################################################//
//#####//############################################################Z########//
//############################################################################//
//############################################################################//
//############################################################################//
//######################################a#################################[#]#//
//############################################################################//
////////////////////////////////////////////////////////////////////////////////
