#///////////////////////////////////////////////////////////////////////////////
//############################################################################//
//#[#]########################################################################//
//############################################################################//
//############################################################################//
//############################################################################//
//############################################################################//
//#################################################////////////////###########//
//############################################################################//
//############################################################################//
//############################################################################//
//########################//##################################################//
//########################//##################################################//
//########################//##################################################//
//########################//##################################################//
//########################//###########////////////////#######################//
//########################//###//#############################################//
//########################//###//#############################################//
//########################//###//##################//#########################//
//########################//###//##################//#########################//
//########################//###//##################//#########################//
//########################//###//##################//#########################//
//########################//###//##################//#########################//
//########################//###//##################//#########################//
//########################//###//##################//#########################//
//########################//###//##################//#########################//
//#############################//##################//#########################//
//#############################//##################//#########################//
//#############################//##################//#########################//
//##############////////////////###################//#########################//
//#################################################//#########################//
//##########################//#####################//#########################//
//##########################//#####################//#########################//
//############################################################################//
//############################################################################//
//############################################################################//
//############################################################################//
//########################################################################[#]#//
//############################################################################//
////////////////////////////////////////////////////////////////////////////////
