#///////////////////////////////////////////////////////////////////////////////
//############################################################################//
//#[#]########################################################################//
//############################################################################//
//############################################################################//
//############################################################################//
//####//######################################################################//
//####//######################################################################//
//####//////##################################################################//
//####//################################A#####################################//
//####//######################################################################//
//####//###################################################################//#//
//####//######################################################################//
//####//#######//#////////////////############################################//
//#############//#############################################################//
//#############//#############################################################//
//#############//#############################################################//
//#############//#############################################################//
//######//#####//#############################################################//
//######//#####//#############################################################//
//######//#####//#############################################################//
//######//#####//#############################################################//
//######//#####//#############################################################//
//######//#####//#############################################################//
//######//#####//#############################################################//
//######//#####//################################################//###########//
//######//#####//################################################//###########//
//###############################################################//###########//
//####//#########################################################//###########//
//####//#########################################################//###########//
//####//#########################################################//###########//
//####//##########################////////////////####/////////////###########//
//####//######################################################################//
//####//######################################################################//
//############################################################################//
//############################################################################//
//############################################################################//
//########################################################################[#]#//
//############################################################################//
////////////////////////////////////////////////////////////////////////////////
