////////////////////////////////////////////////////////////////////////////////
//############################################################################//
//#[#]########################################################################//
//############################################################################//
//############################################################################//
//############################################################################//
//############################//##############################################//
//############################//##############################################//
//############################//##############################################//
//##############################//############################################//
//##############################//############################################//
//##############################//############################################//
//##############################//############################################//
//##############################//########//##################################//
//##############################//########//##################################//
//##############################//############################################//
//###########////////////////###//############################################//
//##############################//############################################//
//###########################################//#########################//####//
//###########################################//#########################//####//
//###########################################//#########################//####//
//#####////////////////######################//#########################//####//
//###########################################//#########################//####//
//###########################################//#########################//####//
//##################////////////////#########//#########################//####//
//###########################################//#########################//####//
//###########################################//#########################//####//
//###########################################//#########################//####//
//###############################//#####################################//####//
//###############################//#####################################//####//
//###############################//#####################################//####//
//###############################//#####################################//####//
//###############################//#####################################//####//
//###############################//###########################################//
//############################################################################//
//############################################################################//
//############################################################################//
//######################################a#################################[#]#//
//############################################################################//
////////////////////////////////////////////////////////////////////////////////
