////////////////////////////////////////////////////////////////////////////////
//############################################################################//
//#[#]########################################################################//
//############################################################################//
//############################################################################//
//############//##############################################################//
//#########//#//##############################################################//
//#########//#//##############################################################//
//#########//#//##############################################################//
//############//##############################################################//
//############//##############################################################//
//############//##############################################################//
//############//##############################################################//
//############//##############################################################//
//#####//#####//##############################################################//
//#####//#####//##############################################################//
//#####//#####//##############################################################//
//#####//#####//###################################////////////////###########//
//#####//#####//##############################################################//
//#####//#####//##############################################################//
//#####//#####//##############################################################//
//#####//#####//##############################################################//
//#####//#####//##############################################################//
//#####//#####//##############################################################//
//#####//#####################################################################//
//#####//#####################################################################//
//#####//######################////////////////###############################//
//#####//##############//#####################################################//
//#####//##############//################################////////////////#####//
//#####################//#####################################################//
//#####################//#####################################################//
//#####################//#####################################################//
//#####################//#####################################################//
//#####################//#####################################################//
//############################################################################//
//############################################################################//
//############################################################################//
//######################################a#################################[#]#//
//############################################################################//
////////////////////////////////////////////////////////////////////////////////
