////////////////////////////////////////////////////////////////////////////////
//############################################################################//
//#[#]########################################################################//
//############################################################################//
//############################################################################//
//############################################################################//
//############################################################################//
//############################################################################//
//############################################################################//
//############################################################################//
//#####################################//////////////###########A#############//
//##########################################//################################//
//###############G##########################//################################//
//##########################################//#############################//#//
//#####//############///////////############//################################//
//#####//###################################//################################//
//#####//###################################//################################//
//#####//###################################//################################//
//#####//###################################//################################//
//#####//###################################//#############################//#//
//#####//#################################////################################//
//#####//#################################////################################//
//#####///////############################////################################//
//#####/////##############################////################################//
//#####//#################################//##################################//
//#####//#################################//##################################//
//#####//#################################//##################################//
//#####//#################################//##################################//
//#####//#################A###############//##################################//
//########################################//##################################//
//########################################//##################################//
//####///////#############################//##################################//
//########################################//##################################//
//########################################//######//////////##################//
//############################################################################//
//############################################################################//
//############################################################################//
//######################################b#################################[#]#//
//############################################################################//
////////////////////////////////////////////////////////////////////////////////
