////////////////////////////////////////////////////////////////////////////////
//############################################################################//
//#[#]########################################################################//
//############################################################################//
//############################################################################//
//############################################################################//
//#########################//#################################################//
//#########################//#################################################//
//#########################//#################################################//
//#########################//#################################################//
//#########################//#################################################//
//#########################//#################################################//
//#########################//#################################################//
//#########################//#################################################//
//#########################//#################################################//
//#########################//#################################################//
//#########################//#################################################//
//######//#################//#################################################//
//######//#################//###////////////////#############////#############//
//######//#################//#################################################//
//######//#################//#################################################//
//######//##########################//########################################//
//######//##########################//########################################//
//######//##########################//########################################//
//######//##########################//########################################//
//######//##########################//##################################//####//
//######//##########################//##################################//####//
//######//##########################//########################################//
//######//##########################//##############N#########################//
//######//##########################//#####////////////////////////////#######//
//######//##########################//########################################//
//######//##########################//########################################//
//##################################//########################################//
//##################################//######################################I#//
//############################################################################//
//############################################################################//
//############################################################################//
//######################################d#################################[#]#//
//############################################################################//
////////////////////////////////////////////////////////////////////////////////
