////////////////////////////////////////////////////////////////////////////////
//############################################################################//
//#[#]########################################################################//
//############################################################################//
//############################################################################//
//######################################################################//####//
//############################################################//##########//##//
//################################################////////////################//
//############################################################################//
//##############################////////////////##############################//
//############################################################################//
//############################################################################//
//############################################################################//
//############################################################################//
//#########################A##################################################//
//############################################################################//
//##################################@#########################################//
//#############################//#############################################//
//#############################//#############################################//
//#################//######///////////////######################//############//
//#################//######@####################################//############//
//#################//###################################################//####//
//#################//###################################################//####//
//#################//###########//######################################//####//
//#################/////########//######################################//####//
//#################//###########//######################################//####//
//#################//###########//######################################//####//
//#################//###########//######################################//####//
//#################//###########//######################################//####//
//#################//###########//#############@########################///###//
//####@############//###########//######################################//####//
//#################//###########//############################################//
//#######//########//###########//############################################//
//#######//########//###########//############################################//
//##@###########################//############################################//
//############################################################################//
//############################################################################//
//########################################################################[#]#//
//############################################################################//
////////////////////////////////////////////////////////////////////////////////
