////////////////////////////////////////////////////////////////////////////////
//#################################################################@##########//
//#[#]########################################################################//
//############################################################################//
//############################################################################//
//###########################################@################################//
//####################//######################################################//
//####################//######################################################//
//####################//######################################################//
//####################//#######################################///////########//
//####################//######################################################//
//####################//######################################################//
//####################//######################################################//
//####################//##########################//////######################//
//####################//######################################################//
//####################//###################A##################################//
//####################//##########////////////////############################//
//####################//######################//##############################//
//####################//#############@########//##############################//
//####################//######################//##########//##################//
//####################//######################//##########//##################//
//####///////#################################//##########//##################//
//############################################////////####//##################//
//############################################//##########//##################//
//############################################///////#####//////##############//
//############################################//##########//##################//
//############################################//##########//##################//
//############################################//##########//######@###########//
//############################################//##########//##################//
//###################@########################//##########//##################//
//############################################//##########//##################//
//########################################################//##################//
//########################################################//##################//
//########################################################//##################//
//############################################################################//
//###@########################################################################//
//############################################################################//
//####################################A###################################[#]#//
//############################################################################//
////////////////////////////////////////////////////////////////////////////////
