////////////////////////////////////////////////////////////////////////////////
//############################################################################//
//#[#]########################################################################//
//############################################################################//
//############################################################################//
//############################################################################//
//####////###############//###################################################//
//#######################//###################################################//
//#######################//###################################################//
//#######################//###################################################//
//###############////####//###################################################//
//#######################//###################################################//
//#######################//#########////////##################################//
//#######################//###################################################//
//#######//////////////////////////##################//#######################//
//#######################//##########################//#######################//
//#######################//##########################//#######################//
//#######################//##########################//#######################//
//#######################//##########################//#######################//
//#######################//##########################//#######################//
//#######################//##########################//#######################//
//###################################################//#######################//
//####////////#######################################//#######################//
//#########//########################################//#######################//
//#########//########################################//#######################//
//#########//########################################//#######################//
//#########//########################################//#######################//
//#########//########################################//#########//############//
//#########//########################################//#########//############//
//#########//###################################################//############//
//#########//###################################################//############//
//#########//#################################################################//
//#########//#################################################################//
//############################################################################//
//############################################################################//
//############################################################################//
//############################################################################//
//########################################################################[#]#//
//############################################################################//
////////////////////////////////////////////////////////////////////////////////
