////////////////////////////////////////////////////////////////////////////////
//############################################################################//
//#[#]########################################################################//
//############################################################################//
//############################################################################//
//############################################################################//
//#####################//#############################////####################//
//#####################//#############################////####################//
//#####################//####//#########################//####################//
//#####################//####//#########################//####################//
//#####################//####//#########################//####################//
//#####################//####//#########################//####################//
//#####################//####//#########################//####################//
//##########/////######//####//#########################//####################//
//#####################//####//########################///####################//
//#####################//####//########################///####################//
//###########################//########################///####################//
//###########################//#########//////////////////####################//
//###########################//#########################//####################//
//###########################//#########################//////////////########//
//###########################//###############################################//
//############################################################################//
//############################################################################//
//#########################################################################//#//
//#######################////////#############################################//
//############################################################################//
//############################################################################//
//############################################################################//
//############################################################################//
//####////////################################################################//
//############################################################################//
//############################################################################//
//################################//##########################################//
//################################//##########################################//
//############################################################################//
//############################################################################//
//############################################################################//
//########################################################################[#]#//
//############################################################################//
////////////////////////////////////////////////////////////////////////////////
