////////////////////////////////////////////////////////////////////////////////
//############################################################################//
//#[#]########################################################################//
//############################################################################//
//############################################################################//
//##########################################################//################//
//############################################################//##############//
//############################################################################//
//#########################################////////////////###################//
//############################################################################//
//############################################################################//
//############################################################################//
//#########################/////////##################################//######//
//####################################################################//######//
//####################################################################//######//
//####################################################################//######//
//####################################################################//######//
//####################################################################//######//
//####################################################################//######//
//#################//#################################################//######//
//#################//#################################################//######//
//#################//#################################################//######//
//#################//#################################################//######//
//#################//#################################################//######//
//#################//#################################################//######//
//##########//#####//#################################################//######//
//##########//#####//#########################################################//
//##########//#####//#############################/////////###################//
//##########//#####//#############################//##########################//
//##########//#####//#############################//##########################//
//##########//#####//#############################//#//////////////###########//
//##########//#####//#########################################################//
//##########//#####//#########################################################//
//##########//#####//#########################################################//
//############################################################################//
//############################################################################//
//############################################################################//
//########################################################################[#]#//
//############################################################################//
////////////////////////////////////////////////////////////////////////////////
