////////////////////////////////////////////////////////////////////////////////
//############################################################################//
//#[#]########################################################################//
//############################################################################//
//############################################################################//
//############################################################################//
//############################################################################//
//#############################################################//#############//
//#############################################################//#############//
//#############################################################//#############//
//####//////////////###########################################//#############//
//#############################################################//#############//
//#####################################################Y#######//#############//
//#####################################////////////////##D#####//#############//
//#############################################################//#####///#####//
//######//#####################################################//#############//
//######//#####################################################//#############//
//######//#####################################################//#############//
//######//#####################################################//#############//
//######//#####################################################//#############//
//######////###################################################//#############//
//######////###################################################//#############//
//######////##################################################################//
//######////##################################################################//
//######////##################################################################//
//######////################################################A#################//
//######////##################################################################//
//######////##################################################################//
//######////##################################################################//
//######////##################################################################//
//########//##################################################################//
//########//##################################################################//
//########//##################################################################//
//########//#################################////////////////#################//
//############################################################################//
//############################################################################//
//############################################################################//
//######################################a#################################[#]#//
//############################################################################//
////////////////////////////////////////////////////////////////////////////////
