////////////////////////////////////////////////////////////////////////////////
//############################################################################//
//#[#]########################################################################//
//############################################################################//
//############################################################################//
//############################################################################//
//######################################//###############////////////////#####//
//######################################//################////////////////####//
//######################################//#################//#################//
//######################################//#################//#################//
//######################################//#################//#################//
//######################################//#################//#################//
//######################################//####################################//
//######################################//####################################//
//######################################//####################################//
//######################################//####################################//
//######################################//####################################//
//######################################//######//############################//
//##############################################//############################//
//##############################################//############################//
//##############################################//#########################//#//
//##################################//##########//############################//
//##################################//##########//############################//
//##################################//##########//############################//
//#############///////////////##################//#####//#####################//
//##############################################//#####//#####################//
//##############################################//#####//#####################//
//##############################################//#####//#####################//
//##############################################//#####//#####################//
//##############################################//#####//#####################//
//##############################################//#####//#####################//
//##############################################//#####//#####################//
//#####################################################//#####################//
//#####################################################//#####################//
//############################################################################//
//############################################################################//
//############################################################################//
//########################################################################[#]#//
//############################################################################//
////////////////////////////////////////////////////////////////////////////////
