////////////////////////////////////////////////////////////////////////////////
//############################################################################//
//#[#]########################################################################//
//############################################################################//
//############################################################################//
//############################################################################//
//#####//############################//#############//########################//
//#####//############################//#############//########################//
//#####//############################//#############//########################//
//#####//###########################################//########################//
//#####//################////////////////###########//########################//
//#####//###########################################//########################//
//#####//###########################################//########################//
//##################################################//########################//
//##################################################//########################//
//##################################################//########################//
//##################################################/////////////#############//
//##################################################//########################//
//############################################################################//
//##########//################################################################//
//##########//################################################################//
//##########//################################################################//
//##########//################################################################//
//##########//###############################################//###############//
//####/////#//###############################################//###############//
//##########//###############################################//###############//
//##########//###############################################//###############//
//###########################################################//###############//
//###########################################################//###############//
//############////////////###################################//###############//
//###########################################################//#//////########//
//########################################################//#//###############//
//########################################################//#//###############//
//########################################################//#//###############//
//############################################################################//
//############################################################################//
//############################################################################//
//########################################################################[#]#//
//############################################################################//
////////////////////////////////////////////////////////////////////////////////
