////////////////////////////////////////////////////////////////////////////////
//############################################################################//
//#[#]########################################################################//
//############################################################################//
//############################################################################//
//############################################################################//
//###################################################################//#######//
//##################//###############################################//#######//
//##################//###############################################//#######//
//##################//////###################################//######//#######//
//##################//#######################################//######//#######//
//##################//#######################################//######//#######//
//##################//#######################################//###############//
//##################//#######################################//###############//
//##################//////////////###########################//###############//
//##################//#######################################//###############//
//##################//#######################################//###############//
//##################//##########################//###########//###############//
//##################//##########################//#############////##A########//
//############////////##########################//////////####################//
//##################//##########################//############################//
//##################//##########################//############################//
//##############################################//############################//
//##############################################//############################//
//##############################################//############################//
//##############################################//############################//
//##############################################//############################//
//###A##########A#############################################################//
//##########////////////////##################################################//
//###############################//###########################################//
//###############################//###########################################//
//###############################//###########################################//
//###############################//###########################################//
//###############################//###########################################//
//############################################################################//
//############################################################################//
//############################################################################//
//######################################a#################################[#]#//
//############################################################################//
////////////////////////////////////////////////////////////////////////////////
