////////////////////////////////////////////////////////////////////////////////
//############################################################################//
//#[#]########################################################################//
//############################################################################//
//############################################################################//
//############################################################################//
//####################################/////###################################//
//############################################################################//
//############################################################################//
//############################################################################//
//############################################################################//
//############################################################################//
//############################################################################//
//############################################################################//
//############################################################################//
//############################################################################//
//######///////////////##//###############################//##################//
//####////////////#######//###############################//##################//
//#######################//###############################//##################//
//#######################//###############################//##################//
//#######################//###############################//##################//
//#######################//###############################//##################//
//#######################//###############################//##########A#######//
//#######################//###############################//##################//
//#####################A#//###############################//##################//
//#######################//###############################//##################//
//#######################//###############################//##################//
//#######################//#######////////////////########////################//
//###############//######//###############################////################//
//###############//######//###############################////################//
//###############//######//###############################////################//
//###############//#########################################//################//
//###############//################################//#######//################//
//###############//################################//#######//################//
//############################################################################//
//############################################################################//
//############################################################################//
//######################################a#################################[#]#//
//############################################################################//
////////////////////////////////////////////////////////////////////////////////
