#///////////////////////////////////////////////////////////////////////////////
//############################################################################//
//#[#]########################################################################//
//######################################################################@#####//
//############################################################################//
//############################################################################//
//##############################################////////////////##############//
//############################################################################//
//#####################@#####//###############################################//
//###########################//###############################################//
//###########################//###############################################//
//###########################//###############################################//
//###########################//#####################################//########//
//###########################//#####################################//########//
//###########################//#####################################//########//
//###########################//#####################################//########//
//###########################//#####################################//########//
//###########################//#####################################//########//
//###########################//##############//###############################//
//###########################//##############//###############################//
//######################//###//##############//###############################//
//######################//###################//###############################//
//######################//##################@//###############################//
//######################//######//@##########//###############################//
//##############################//###########//###############################//
//##############################//###########//#####////////////////##########//
//##############################//###########//###############################//
//##############################//#########////////////////###################//
//##############################//############################################//
//##############################//############################################//
//##############################//############################################//
//##############################//############################################//
//#####################//#######//############################################//
//#####################//#######//#######################@####################//
//############################################################################//
//############################################################################//
//############################################################################//
//########################################################################[#]#//
//############################################################################//
////////////////////////////////////////////////////////////////////////////////
