////////////////////////////////////////////////////////////////////////////////
//############################################################################//
//#[#]########################################################################//
//############################################################################//
//############################################################################//
//############################################################################//
//#################################################//#########################//
//#################################################//#########################//
//#################################################//#########################//
//#################################################//#########################//
//#############################/////###############//#########################//
//############################################################################//
//#########################################//#################################//
//#########################################//#################################//
//######################################//#//##////////////////###############//
//######################################//#//###########//####################//
//######################################//##############//####################//
//######################################//##############//####################//
//####////////////######################//##############//####################//
//######################################//##############//####################//
//#########//###########################//##############//####################//
//#########//###########################//##############//####################//
//#########//###########################//##############//####################//
//#########//#//########################################//####################//
//#########//#//##############################################################//
//#########//#//##############################################################//
//############//##############################################################//
//############//##############################################################//
//############//##############################################################//
//############//##############################################################//
//############//##############################################################//
//############//##############################################################//
//############//#######################///////////////########################//
//############//##############################################################//
//############################################################################//
//############################################################################//
//############################################################################//
//########################################################################[#]#//
//############################################################################//
////////////////////////////////////////////////////////////////////////////////
