#///////////////////////////////////////////////////////////////////////////////
//############################################################################//
//#[#]########################################################################//
//############################################################################//
//############################################################################//
//############################################################################//
//##################//##########################//############################//
//##################//##########################//############################//
//##################//##########################//############################//
//##################//##################//######//############################//
//##################//##################//######//############################//
//##################//########////////////######//############################//
//##################//##################//######//############################//
//##################//##################//######//############################//
//##################//##################//####################################//
//####///###########//##################////////##############################//
//######################################//####################################//
//######################################//####################################//
//######################################//####################################//
//######################################//####################################//
//######################################//####################################//
//######################################//####################################//
//######################################//#######//#############//############//
//######################################//#######//#############//############//
//###############################################//#############//############//
//###############################################//#############//############//
//###############################################//////////###################//
//###############################////############//###########################//
//###########################//////////////######//###########################//
//####/////###################################################################//
//############################################################################//
//############################################################################//
//############################################################################//
//############################################################################//
//############################################################################//
//############################################################################//
//############################################################################//
//########################################################################[#]#//
//############################################################################//
////////////////////////////////////////////////////////////////////////////////
