////////////////////////////////////////////////////////////////////////////////
//############################################################################//
//#[#]##################################a#####################################//
//###################################@########################################//
//############################################################################//
//#################################################A################A#########//
//###########################@################################################//
//################################################A###########################//
//########################################@###################################//
//################################@###########################################//
//############################################################################//
//############################################################################//
//##################////////////////#######################################A##//
//############################################################################//
//#############################///////////###########//#######################//
//######################################//###########//#######################//
//############@#########################//###########//#######################//
//######################################//###########//##################//###//
//#######@##############################//###########//##################//###//
//######################################//###########////////############//###//
//######################################//###########//##################//a##//
//######################################//###########//###############A##//###//
//######################################//###########//##################//###//
//######################################//###########//##################//###//
//######################################//###########//##################//###//
//######################################//###########//##################//###//
//######################################//###########//##################//###//
//######################################//###########//##################//###//
//######################################//###########//##################//###//
//######################################//###############################//###//
//#######################################################################//###//
//#######################################################################//###//
//###########################################////////////////#################//
//############################################################################//
//############################################################################//
//############################################################################//
//####A@######################################################################//
//#####################A#######@########a#################################[#]#//
//############################################################################//
////////////////////////////////////////////////////////////////////////////////
