#///////////////////////////////////////////////////////////////////////////////
//############################################################################//
//#[#]########################################################################//
//############################################################################//
//############################################################################//
//############################################################################//
//#######//###//##############################################################//
//#######//###//##############################################################//
//#######//###//################################////////////////##############//
//#######//###//###############################################@#####//#######//
//#######//###//#####################################################//#######//
//#######//###//#####################################################//#######//
//############//#####################################################//#######//
//###################################################################//#######//
//###################################################################//#//####//
//###################################################################//#//####//
//#############@##########################////////////////###########//#//####//
//###################################################################//#//####//
//###################################################################//#//####//
//###################################################################//#//####//
//###################################################################//#//####//
//######################################@############################//#//####//
//###################################################################//#//####//
//###################################################################//#//####//
//######################################################################//####//
//############################################################################//
//############################################################################//
//############################################################################//
//######################################################################@#####//
//############################################################################//
//############////////////////################################################//
//#################################################//#########################//
//#################################################//#########################//
//#################################################//#########################//
//########################@#############@#####################################//
//############################################################################//
//############################################################################//
//########################################################################[#]#//
//############################################################################//
////////////////////////////////////////////////////////////////////////////////
