#///////////////////////////////////////////////////////////////////////////////
//############################################################################//
//#[#]########################################################################//
//############################################################################//
//############################################################################//
//############################################################################//
//############################################################################//
//############################################################################//
//############################################################################//
//####////////////############################################################//
//############################################################################//
//############################################################################//
//####################################//######################################//
//####################################//######################################//
//####################################//######################################//
//####################################//######################################//
//####################################//######################################//
//####################################//#######//#############################//
//####################################//#######//#############///////#########//
//####################################//#######//#############################//
//####################//##############//#######//#############################//
//####################//##############//#######//#############################//
//####################//##############//#######//#############################//
//####################//##############//#######//#############################//
//####################//##############//#######//#############################//
//####################################//##///////#############################//
//####////////////////################//####//#//#############################//
//############################//////////####//#//#############################//
//##########################################//#//#############################//
//##########################################//#//#############################//
//##########################################//#//#############################//
//##########################################//#//#############################//
//##########################################//################################//
//###############################//#########//################################//
//###############################//###########################################//
//############################################################################//
//############################################################################//
//########################################################################[#]#//
//############################################################################//
////////////////////////////////////////////////////////////////////////////////
