////////////////////////////////////////////////////////////////////////////////
//############################################################################//
//#[#]########################################################################//
//############################################################################//
//############################################################################//
//############################################################################//
//#####################//##################################////////////////###//
//#########///#########//#####################################################//
//#####################//#####################################################//
//#####################//#####################################################//
//#####################//#####################################################//
//#####################//#####################################################//
//#####################//#####################################################//
//############################################################################//
//############################################################################//
//################################//##########################################//
//################################//##########################################//
//################################//##########################################//
//################//###/////////////##########################################//
//################//##############//##########################################//
//####//////######//##############//##########################################//
//#####//#########//##############//##########################################//
//################//##############//##########################################//
//################//##########################################################//
//################//##########################################################//
//####//////////////##########################################################//
//################//##########################################################//
//################//##########################################################//
//################//##########################//##############################//
//################//######//##################//##############################//
//################//######//##################//##############################//
//################//######//##################//##############################//
//################//######//##################//##############################//
//########################//#############//###//##############################//
//#######################################//###################################//
//############################################################################//
//############################################################################//
//########################################################################[#]#//
//############################################################################//
////////////////////////////////////////////////////////////////////////////////
