////////////////////////////////////////////////////////////////////////////////
//############################################################################//
//#[#]########################################################################//
//############################################################################//
//############################################################################//
//############################################################################//
//#######################################//###################################//
//#######################################//###################################//
//#######################################//###################################//
//#############//#############################################################//
//#############//######################################################//#####//
//#############//######################################################//#####//
//#############//######################################################//#####//
//#############//######################################################//#####//
//#############//######################################################//#####//
//#############//######################################################//#####//
//#############//######################################################//#####//
//#############//#######################A##############################//#####//
//#############//#########///////////////#A############################//#####//
//#############//#############////////////////#########################//#####//
//#####################################################################//#####//
//############################################A########################//#####//
//##############################################################//#####//#####//
//##############################################################//#####//#####//
//########//####################################################//#####//#####//
//########//####################################################//############//
//########//####################################################//############//
//##############################################################//############//
//##############################################################//############//
//##############################################################//############//
//############################################////////////////##//############//
//##############################################################//############//
//##############################################################//############//
//##############################################################//############//
//############################################################################//
//############################################################################//
//############################################################################//
//######################################b#################################[#]#//
//############################################################################//
////////////////////////////////////////////////////////////////////////////////
