////////////////////////////////////////////////////////////////////////////////
//############################################################################//
//#[#]########################################################################//
//############################################################################//
//############################################################################//
//############################################################################//
//#################//#########################################################//
//#################//#########################################################//
//#################//####################################////////////////#####//
//#################//#################################################//######//
//#################//#################################################//######//
//#################//#################################################//######//
//#################//#########################################################//
//#################//#########################################################//
//#############//##//#########################################################//
//#############//##//#########################################################//
//#############//##//#########################################################//
//#############//##//#########################################################//
//#############//##//#########################################################//
//#############//##//#########################################################//
//#############//#############################################################//
//#############//#############################################################//
//#############//#############################################################//
//#############////###########################################################//
//#############//#############################################################//
//#############//###//########################################################//
//#############//###//########################################################//
//#############//###//#####///////////////####################################//
//#############//###//########################################################//
//##################//#//#####################################################//
//#####################//#####################################################//
//#####################//#/////###############################################//
//####////////////#####//#####################################################//
//#####################//#####################################################//
//############################################################################//
//############################################################################//
//############################################################################//
//########################################################################[#]#//
//############################################################################//
////////////////////////////////////////////////////////////////////////////////
