////////////////////////////////////////////////////////////////////////////////
//############################################################################//
//#[#]########################################################################//
//############################################################################//
//############################################################################//
//############################################################################//
//#################################################//#########################//
//#################################################//#########################//
//#################################################//#########################//
//#################################################//#########################//
//#################################################//#########################//
//####////#########################################//#########################//
//#################################################//#########################//
//#################################################//#########################//
//#################################################//#########################//
//####////#########################################//#########################//
//##########################/////////////##########//#########################//
//############################################################################//
//############################################################################//
//############################################################################//
//############################################################################//
//############################################################################//
//#######//###################################################################//
//#######//###################################################################//
//#######//###################################################################//
//#######//#////////////////##################################################//
//#######//###################################################################//
//#######//#////////////###############################//#######//############//
//#######//#//#####################//##################//#######//############//
//#######//#//#####################//##################//#######//############//
//#######//#//#####################//##################//#######//############//
//#######//#//#########################################//#####################//
//#######//#//#########################################//#####################//
//#######//#//################################################################//
//############################################################################//
//############################################################################//
//############################################################################//
//########################################################################[#]#//
//############################################################################//
////////////////////////////////////////////////////////////////////////////////
