////////////////////////////////////////////////////////////////////////////////
//############################################################################//
//#[#]########################################################################//
//############################################################################//
//############################################################################//
//############################################################################//
//##########################//#//#########//##################################//
//##########################//#//#########//##################################//
//##########################//##//########//##################################//
//##########################//##//############################################//
//##########################//##//############################################//
//##########################//##//############################################//
//##########################//##//############################################//
//##########################//##//############################################//
//##########################//##//############################################//
//##########################//##//############################################//
//##########################//##//############################################//
//##############################//############################################//
//##############################//#################//////////#################//
//##############################//############################################//
//############################################################//##############//
//############################################################//##############//
//############################################################################//
//########################################////////////////####################//
//############################################################################//
//############################################################################//
//##########################////////////////##################################//
//############################################################################//
//###################################################################//#######//
//###################################################################//#######//
//##############################################################//###//#######//
//##################//##########################################//###//#######//
//##################//##########################################//###//#######//
//####///////#######//##########################################//###//#######//
//############################################################################//
//############################################################################//
//############################################################################//
//########################################################################[#]#//
//############################################################################//
////////////////////////////////////////////////////////////////////////////////
