////////////////////////////////////////////////////////////////////////////////
//############################################################################//
//#[#]########################################################################//
//############################################################################//
//############################################################################//
//############################################################################//
//#######################//###################################################//
//#######################//###################################################//
//#######################//###################################################//
//#######################//###################################################//
//#######################//########//#########################################//
//#######################//########//#########################################//
//####//////////#########//########//###############################//########//
//#################################//###############################//########//
//#################################//##########//#####//////########//########//
//#################################//##########//###################//########//
//#################################//##########//###################//########//
//#################################//##########//###################//########//
//#################################//##########//###################//########//
//#################################//##########//###################//########//
//#################################//##########//###################//########//
//#################################//##########//###################//########//
//#################################//###############################//########//
//#################################//###############################//########//
//#################################//###############################//########//
//##################################################################//########//
//##################################################################//########//
//##########////////////////##################################################//
//############################################################################//
//############################################################################//
//############################################################################//
//############################################################################//
//############################################################################//
//#######////////////////#####################################################//
//############################################################################//
//############################################################################//
//############################################################################//
//########################################################################[#]#//
//############################################################################//
////////////////////////////////////////////////////////////////////////////////
