////////////////////////////////////////////////////////////////////////////////
//############################################################################//
//#[#]########################################################################//
//############################################################################//
//############################################################################//
//############################################################################//
//############################################################################//
//############################################################################//
//##########################################################///////////////###//
//############################################################################//
//####//######################################################################//
//####//######################################################################//
//############################################################################//
//####################//######################################################//
//####################//######################################################//
//####################//######################################################//
//####################//######################################################//
//####################//######////////////////################################//
//####################//######//##############################################//
//####################//######//#####///////////##############################//
//####################//######//##############################################//
//####################//######//###########################//#################//
//####################//######//###########################//#################//
//####################//######//###########################//#################//
//####################//######//###########################//#################//
//####################//######//###########################//#################//
//####################//######//###########################//#################//
//####################//######//###########################//#################//
//############################//###########################//#################//
//############################//###########################////////###########//
//############################//###########################//#################//
//############################//###########################//#################//
//#########################################################//#################//
//#########################################################//#################//
//############################################################################//
//############################################################################//
//############################################################################//
//########################################################################[#]#//
//############################################################################//
////////////////////////////////////////////////////////////////////////////////
