////////////////////////////////////////////////////////////////////////////////
//############################################################################//
//#[#]########################################################################//
//############################################################################//
//############################################################################//
//###################//#######################################################//
//########//#########//#######################################################//
//########//##################################################################//
//########//###################//#############################################//
//########//###################//###########//################################//
//########//###################//###########//################################//
//########//###################//###########//################################//
//########//###################//###########///////////#######################//
//########//###################//###########//################################//
//########//###################//###########//################################//
//########//###################//###########//################################//
//########//###################//###########//################################//
//########////#################//###########//################################//
//####////////#################//###########//################################//
//#############################//###########//################################//
//#############################//###########//################################//
//#############################//#A#########//################################//
//#############################//###########//################################//
//##########################################//A##################A############//
//############################################################################//
//######///###################################################################//
//####////////////############################################################//
//############################################################################//
//############################################################################//
//#############################////////////////###############################//
//############################################################################//
//############################################################################//
//############################################################################//
//############################################################################//
//############################################################################//
//############################################################################//
//############################################################################//
//######################################a#################################[#]#//
//############################################################################//
////////////////////////////////////////////////////////////////////////////////
