////////////////////////////////////////////////////////////////////////////////
//############################################################################//
//#[#]########################################################################//
//############################################################################//
//############################################################################//
//############################################################################//
//######################//#######//###########################################//
//######################//#######//###########################################//
//######################//#######//###########################################//
//######################//#######//###########################################//
//######################//#######//#################@#########################//
//####//////////////####//#######//###########################################//
//######################//#######//###########################################//
//###############################//###########################################//
//#####################################################//#####################//
//#####################################################//#####################//
//#################################################@###//#####################//
//#####################################################//#####################//
//#####################################################//@####################//
//##################################################//#//#####################//
//##################################################//#//#####################//
//##################################################//#//#####################//
//##################################################//#//#####################//
//##################################################//#//#####################//
//##################################################//#//################//###//
//###################################################////################///##//
//###################################################////################//###//
//###################################################////########@#######//###//
//###################################################////#####################//
//###################////////////////################//#######################//
//##################////////////////#################//#######################//
//############################################################################//
//############################################################################//
//############################################################################//
//############################################################################//
//############################################################################//
//############################################################################//
//########################################################################[#]#//
//############################################################################//
////////////////////////////////////////////////////////////////////////////////
