#///////////////////////////////////////////////////////////////////////////////
//############################################################################//
//#[#]########################################################################//
//############################################################################//
//############################################################################//
//############################//###@#####@#######S#########################S##//
//####//######################//###############################//#############//
//####//######################//###############################//#############//
//####//######################//###############################//#############//
//####//######################///////////###########@##########//#############//
//####//######################///////////////##################//#####S#######//
//####//######################//###############################//#############//
//####//######################//////###########################//#############//
//####//######################////#############################//#############//
//####//######################////#############################//#############//
//############################////#############################//#############//
//#############################################################//#############//
//#############################################################//#############//
//#############################################################//#############//
//#############################################################//#############//
//############################################################################//
//####################################################//######################//
//#####################################@##############//######################//
//####################################################//######################//
//##################################################////////////////##########//
//############################################################################//
//#####@######################################################################//
//############################################################################//
//############################################################################//
//############################################################################//
//############################################################################//
//###################//##########///////######################################//
//###################//#######################################################//
//###################//#######################################################//
//######################################@#####################################//
//############################################################################//
//############################################################################//
//########################################################################[#]#//
//############################################################################//
////////////////////////////////////////////////////////////////////////////////
