#///////////////////////////////////////////////////////////////////////////////
//############################################################################//
//#[#]########################################################################//
//############################################################################//
//############################################################################//
//############################################################################//
//##############################################//############################//
//#########//###################################//###################//#######//
//#####////////////////#########################//###################//#######//
//##############################################//###################//#######//
//###################################################################//#######//
//###################################//##############################//#######//
//###################################//#////////////////#############//#######//
//##############S####################//##############################//#######//
//###################################//##############################//#######//
//###################################//#######///////////////########//###S###//
//###################################//#######################################//
//###S###############################//#######################################//
//###################################//#######################################//
//###################################//#######################################//
//###################################//########//#############################//
//###################################//########//#############################//
//###################################//########//#############################//
//###################################//########//#############################//
//###################################//########//#############################//
//###################################//########//#############################//
//#############################################//#############################//
//#############################################//#############################//
//#############################################//#############################//
//#############################################//#############################//
//#############################################//#############################//
//#############################################//#############################//
//########################//###################//#############################//
//########################//###################//#############################//
//############################################################################//
//############################################################################//
//############################################################################//
//########################################################################[#]#//
//############################################################################//
////////////////////////////////////////////////////////////////////////////////
