#///////////////////////////////////////////////////////////////////////////////
//############################################################################//
//#[#]########################################################################//
//############################################################################//
//############################################################################//
//############################################################################//
//####################//##############################################//######//
//####################//##############################################//######//
//####################//###////////////////###########################//######//
//####################//######################################################//
//####################//####//################################################//
//####################//####//################################################//
//####################//####//################################################//
//####################//####//###############################V################//
//#################//#//####//################################################//
//#################//#//####//################################################//
//#################//#//####//################################################//
//#################//#//####//################################################//
//#################//#//####//################################################//
//#################//#//####//################################################//
//#################//#//####//#################////////////////###############//
//#################//#######//################################################//
//#################//#######//####////////////////############################//
//#################//#######//################################################//
//#################//#######//################################################//
//############################################################################//
//############################################################################//
//############################################################################//
//############################################################################//
//############################################################################//
//############################################################################//
//############################################################################//
//############################################################################//
//############################################################################//
//############################################################################//
//############################################################################//
//############################################################################//
//########################################################################[#]#//
//############################################################################//
////////////////////////////////////////////////////////////////////////////////
