////////////////////////////////////////////////////////////////////////////////
//############################################################################//
//#[#]########################################################################//
//############################################################################//
//############################################################################//
//############################################################################//
//############################################################################//
//############################################################################//
//############################################//##############################//
//############################################//##############################//
//############################################//##############################//
//########//##################################//##############################//
//########//##################################//##############################//
//########//##################################//##############################//
//########//##################################//####################//########//
//########//##################################//####################//########//
//########//##################################//####################//########//
//########//##################################//####################//########//
//########//##################################//####################//########//
//########//##################################//####################//########//
//########//##################################//####################//########//
//########//##################################//####################//########//
//########//##############################////////////////##########//########//
//##########////////////////########################################//########//
//##################################################################//########//
//##################################################################//########//
//##################################################################//########//
//################################//##########################################//
//################################//############////////////////##############//
//################################//##########################################//
//################################//##########################################//
//############################################################################//
//############################################################################//
//############################################################################//
//############################################################################//
//############################################################################//
//############################################################################//
//######################################a#################################[#]#//
//############################################################################//
////////////////////////////////////////////////////////////////////////////////
